Zip Code,Date,Total Doses - Daily,Total Doses - Cumulative,1st Dose - Daily,1st Dose - Cumulative,1st Dose - Percent Population,Vaccine Series Completed - Daily,Vaccine Series Completed - Cumulative,Vaccine Series Completed  - Percent Population,Population,ZIP Code Location,Row_ID
60601,12/24/2020,9,306,9,306,0.02,0,0,0,15083,POINT (-87.622844 41.886262),60601-20201224
60601,12/25/2020,0,306,0,306,0.02,0,0,0,15083,POINT (-87.622844 41.886262),60601-20201225
60601,12/26/2020,10,316,10,316,0.021,0,0,0,15083,POINT (-87.622844 41.886262),60601-20201226
60601,12/27/2020,0,316,0,316,0.021,0,0,0,15083,POINT (-87.622844 41.886262),60601-20201227
60601,12/29/2020,27,365,27,365,0.024,0,0,0,15083,POINT (-87.622844 41.886262),60601-20201229
60601,12/30/2020,34,399,34,399,0.026,0,0,0,15083,POINT (-87.622844 41.886262),60601-20201230
60601,12/31/2020,14,413,14,413,0.027,0,0,0,15083,POINT (-87.622844 41.886262),60601-20201231
60601,01/01/2021,1,414,1,414,0.027,0,0,0,15083,POINT (-87.622844 41.886262),60601-20210101
60601,01/02/2021,8,422,8,422,0.028,0,0,0,15083,POINT (-87.622844 41.886262),60601-20210102
60601,01/03/2021,5,427,5,427,0.028,0,0,0,15083,POINT (-87.622844 41.886262),60601-20210103
60601,01/04/2021,33,460,31,458,0.03,2,2,0,15083,POINT (-87.622844 41.886262),60601-20210104
60601,01/05/2021,36,496,34,492,0.033,2,4,0,15083,POINT (-87.622844 41.886262),60601-20210105
60601,01/06/2021,20,516,13,505,0.033,7,11,0.001,15083,POINT (-87.622844 41.886262),60601-20210106
60601,01/07/2021,56,572,18,523,0.035,38,49,0.003,15083,POINT (-87.622844 41.886262),60601-20210107
60601,01/08/2021,84,656,22,545,0.036,62,111,0.007,15083,POINT (-87.622844 41.886262),60601-20210108
60601,01/09/2021,45,701,11,556,0.037,34,145,0.01,15083,POINT (-87.622844 41.886262),60601-20210109
60601,01/10/2021,12,713,3,559,0.037,9,154,0.01,15083,POINT (-87.622844 41.886262),60601-20210110
60601,01/11/2021,64,777,10,569,0.038,54,208,0.014,15083,POINT (-87.622844 41.886262),60601-20210111
60601,01/12/2021,73,850,27,596,0.04,46,254,0.017,15083,POINT (-87.622844 41.886262),60601-20210112
60601,01/13/2021,49,899,27,623,0.041,22,276,0.018,15083,POINT (-87.622844 41.886262),60601-20210113
60602,01/16/2021,7,117,7,87,0.076,0,30,0.026,1145,POINT (-87.628309 41.883136),60602-20210116
60602,01/17/2021,3,120,2,89,0.078,1,31,0.027,1145,POINT (-87.628309 41.883136),60602-20210117
60606,02/02/2021,12,514,9,362,0.11,3,152,0.046,3287,POINT (-87.63676 41.882634),60606-20210202
60606,02/03/2021,9,523,9,371,0.113,0,152,0.046,3287,POINT (-87.63676 41.882634),60606-20210203
60616,01/16/2021,55,2453,36,1810,0.033,19,643,0.012,54197,POINT (-87.629531 41.844869),60616-20210116
60616,01/17/2021,18,2471,8,1818,0.034,10,653,0.012,54197,POINT (-87.629531 41.844869),60616-20210117
60619,01/16/2021,25,892,24,783,0.013,1,109,0.002,61207,POINT (-87.60569 41.744737),60619-20210116
60619,01/17/2021,6,898,3,786,0.013,3,112,0.002,61207,POINT (-87.60569 41.744737),60619-20210117
60619,01/18/2021,49,947,37,823,0.013,12,124,0.002,61207,POINT (-87.60569 41.744737),60619-20210118
60619,01/19/2021,108,1055,85,908,0.015,23,147,0.002,61207,POINT (-87.60569 41.744737),60619-20210119
60619,01/20/2021,121,1176,89,997,0.016,32,179,0.003,61207,POINT (-87.60569 41.744737),60619-20210120
60619,01/21/2021,180,1356,150,1147,0.019,30,209,0.003,61207,POINT (-87.60569 41.744737),60619-20210121
60619,01/22/2021,260,1616,251,1398,0.023,9,218,0.004,61207,POINT (-87.60569 41.744737),60619-20210122
60619,01/23/2021,100,1716,97,1495,0.024,3,221,0.004,61207,POINT (-87.60569 41.744737),60619-20210123
60619,01/24/2021,30,1746,28,1523,0.025,2,223,0.004,61207,POINT (-87.60569 41.744737),60619-20210124
60619,01/25/2021,138,1884,120,1643,0.027,18,241,0.004,61207,POINT (-87.60569 41.744737),60619-20210125
60619,01/26/2021,155,2039,123,1766,0.029,32,273,0.004,61207,POINT (-87.60569 41.744737),60619-20210126
60619,01/27/2021,190,2229,167,1933,0.032,23,296,0.005,61207,POINT (-87.60569 41.744737),60619-20210127
60619,01/28/2021,211,2440,193,2126,0.035,18,314,0.005,61207,POINT (-87.60569 41.744737),60619-20210128
60619,01/29/2021,291,2731,270,2396,0.039,21,335,0.005,61207,POINT (-87.60569 41.744737),60619-20210129
60619,01/30/2021,108,2839,96,2492,0.041,12,347,0.006,61207,POINT (-87.60569 41.744737),60619-20210130
60619,01/31/2021,15,2854,14,2506,0.041,1,348,0.006,61207,POINT (-87.60569 41.744737),60619-20210131
60619,02/01/2021,139,2993,114,2620,0.043,25,373,0.006,61207,POINT (-87.60569 41.744737),60619-20210201
60621,01/22/2021,34,483,31,433,0.015,3,50,0.002,28018,POINT (-87.638812 41.776931),60621-20210122
60621,01/23/2021,19,502,19,452,0.016,0,50,0.002,28018,POINT (-87.638812 41.776931),60621-20210123
60621,01/24/2021,3,505,3,455,0.016,0,50,0.002,28018,POINT (-87.638812 41.776931),60621-20210124
60621,01/25/2021,103,608,94,549,0.02,9,59,0.002,28018,POINT (-87.638812 41.776931),60621-20210125
60621,01/26/2021,34,642,22,571,0.02,12,71,0.003,28018,POINT (-87.638812 41.776931),60621-20210126
60621,01/27/2021,124,766,83,654,0.023,41,112,0.004,28018,POINT (-87.638812 41.776931),60621-20210127
60621,01/28/2021,47,813,40,694,0.025,7,119,0.004,28018,POINT (-87.638812 41.776931),60621-20210128
60621,01/29/2021,149,962,95,789,0.028,54,173,0.006,28018,POINT (-87.638812 41.776931),60621-20210129
60621,01/30/2021,17,979,15,804,0.029,2,175,0.006,28018,POINT (-87.638812 41.776931),60621-20210130
60621,01/31/2021,0,979,0,804,0.029,0,175,0.006,28018,POINT (-87.638812 41.776931),60621-20210131
60621,02/01/2021,24,1003,21,825,0.029,3,178,0.006,28018,POINT (-87.638812 41.776931),60621-20210201
60621,02/02/2021,29,1032,19,844,0.03,10,188,0.007,28018,POINT (-87.638812 41.776931),60621-20210202
60621,02/03/2021,45,1077,37,881,0.031,8,196,0.007,28018,POINT (-87.638812 41.776931),60621-20210203
60622,01/06/2021,191,2571,171,2529,0.047,20,42,0.001,53294,POINT (-87.681818 41.902762),60622-20210106
60622,01/07/2021,274,2845,84,2613,0.049,190,232,0.004,53294,POINT (-87.681818 41.902762),60622-20210107
60622,01/08/2021,341,3186,67,2680,0.05,274,506,0.009,53294,POINT (-87.681818 41.902762),60622-20210108
60622,01/09/2021,245,3431,52,2732,0.051,193,699,0.013,53294,POINT (-87.681818 41.902762),60622-20210109
60622,01/10/2021,54,3485,16,2748,0.052,38,737,0.014,53294,POINT (-87.681818 41.902762),60622-20210110
60622,01/11/2021,301,3786,93,2841,0.053,208,945,0.018,53294,POINT (-87.681818 41.902762),60622-20210111
60622,01/12/2021,269,4055,109,2950,0.055,160,1105,0.021,53294,POINT (-87.681818 41.902762),60622-20210112
60622,01/13/2021,212,4267,96,3046,0.057,116,1221,0.023,53294,POINT (-87.681818 41.902762),60622-20210113
60622,01/14/2021,202,4469,164,3210,0.06,38,1259,0.024,53294,POINT (-87.681818 41.902762),60622-20210114
60622,01/15/2021,114,4583,105,3315,0.062,9,1268,0.024,53294,POINT (-87.681818 41.902762),60622-20210115
60624,01/18/2021,5,434,5,381,0.011,0,53,0.002,34892,POINT (-87.722735 41.879417),60624-20210118
60624,01/19/2021,28,462,15,396,0.011,13,66,0.002,34892,POINT (-87.722735 41.879417),60624-20210119
60624,01/20/2021,59,521,46,442,0.013,13,79,0.002,34892,POINT (-87.722735 41.879417),60624-20210120
60624,01/21/2021,56,577,44,486,0.014,12,91,0.003,34892,POINT (-87.722735 41.879417),60624-20210121
60624,01/22/2021,45,622,41,527,0.015,4,95,0.003,34892,POINT (-87.722735 41.879417),60624-20210122
60624,01/23/2021,15,637,15,542,0.016,0,95,0.003,34892,POINT (-87.722735 41.879417),60624-20210123
60624,01/24/2021,3,640,2,544,0.016,1,96,0.003,34892,POINT (-87.722735 41.879417),60624-20210124
60624,01/25/2021,50,690,35,579,0.017,15,111,0.003,34892,POINT (-87.722735 41.879417),60624-20210125
60624,01/26/2021,41,731,27,606,0.017,14,125,0.004,34892,POINT (-87.722735 41.879417),60624-20210126
60624,01/27/2021,76,807,60,666,0.019,16,141,0.004,34892,POINT (-87.722735 41.879417),60624-20210127
60624,01/28/2021,76,883,64,730,0.021,12,153,0.004,34892,POINT (-87.722735 41.879417),60624-20210128
60624,01/29/2021,110,993,104,834,0.024,6,159,0.005,34892,POINT (-87.722735 41.879417),60624-20210129
60624,01/30/2021,28,1021,22,856,0.025,6,165,0.005,34892,POINT (-87.722735 41.879417),60624-20210130
60624,01/31/2021,6,1027,6,862,0.025,0,165,0.005,34892,POINT (-87.722735 41.879417),60624-20210131
60624,02/01/2021,117,1144,107,969,0.028,10,175,0.005,34892,POINT (-87.722735 41.879417),60624-20210201
60624,02/02/2021,90,1234,68,1037,0.03,22,197,0.006,34892,POINT (-87.722735 41.879417),60624-20210202
60626,01/07/2021,100,1179,75,1135,0.022,25,44,0.001,50544,POINT (-87.669834 42.009469),60626-20210107
60634,01/07/2021,117,1230,55,1147,0.015,62,83,0.001,75082,POINT (-87.797373 41.944967),60634-20210107
60634,01/08/2021,318,1548,217,1364,0.018,101,184,0.002,75082,POINT (-87.797373 41.944967),60634-20210108
60634,01/09/2021,73,1621,31,1395,0.019,42,226,0.003,75082,POINT (-87.797373 41.944967),60634-20210109
60634,01/10/2021,28,1649,12,1407,0.019,16,242,0.003,75082,POINT (-87.797373 41.944967),60634-20210110
60634,01/11/2021,100,1749,45,1452,0.019,55,297,0.004,75082,POINT (-87.797373 41.944967),60634-20210111
60634,01/12/2021,129,1878,72,1524,0.02,57,354,0.005,75082,POINT (-87.797373 41.944967),60634-20210112
60634,01/13/2021,145,2023,94,1618,0.022,51,405,0.005,75082,POINT (-87.797373 41.944967),60634-20210113
60634,01/14/2021,81,2104,69,1687,0.022,12,417,0.006,75082,POINT (-87.797373 41.944967),60634-20210114
60634,01/15/2021,195,2299,194,1881,0.025,1,418,0.006,75082,POINT (-87.797373 41.944967),60634-20210115
60636,01/26/2021,44,533,38,454,0.015,6,79,0.003,30024,POINT (-87.668597 41.77599),60636-20210126
60636,01/27/2021,61,594,52,506,0.017,9,88,0.003,30024,POINT (-87.668597 41.77599),60636-20210127
60636,01/28/2021,55,649,52,558,0.019,3,91,0.003,30024,POINT (-87.668597 41.77599),60636-20210128
60636,01/29/2021,104,753,98,656,0.022,6,97,0.003,30024,POINT (-87.668597 41.77599),60636-20210129
60636,01/30/2021,26,779,24,680,0.023,2,99,0.003,30024,POINT (-87.668597 41.77599),60636-20210130
60636,01/31/2021,3,782,2,682,0.023,1,100,0.003,30024,POINT (-87.668597 41.77599),60636-20210131
60636,02/01/2021,34,816,30,712,0.024,4,104,0.003,30024,POINT (-87.668597 41.77599),60636-20210201
60638,01/07/2021,83,786,38,728,0.012,45,58,0.001,58669,POINT (-87.771902 41.787032),60638-20210107
60638,01/08/2021,93,879,33,761,0.013,60,118,0.002,58669,POINT (-87.771902 41.787032),60638-20210108
60638,01/09/2021,56,935,20,781,0.013,36,154,0.003,58669,POINT (-87.771902 41.787032),60638-20210109
60638,01/10/2021,19,954,6,787,0.013,13,167,0.003,58669,POINT (-87.771902 41.787032),60638-20210110
60638,01/11/2021,63,1017,21,808,0.014,42,209,0.004,58669,POINT (-87.771902 41.787032),60638-20210111
60638,01/12/2021,93,1110,42,850,0.014,51,260,0.004,58669,POINT (-87.771902 41.787032),60638-20210112
60638,01/13/2021,89,1199,60,910,0.016,29,289,0.005,58669,POINT (-87.771902 41.787032),60638-20210113
60638,01/14/2021,85,1284,70,980,0.017,15,304,0.005,58669,POINT (-87.771902 41.787032),60638-20210114
60638,01/15/2021,55,1339,45,1025,0.017,10,314,0.005,58669,POINT (-87.771902 41.787032),60638-20210115
60638,01/16/2021,38,1377,28,1053,0.018,10,324,0.006,58669,POINT (-87.771902 41.787032),60638-20210116
60638,01/17/2021,15,1392,13,1066,0.018,2,326,0.006,58669,POINT (-87.771902 41.787032),60638-20210117
60638,01/18/2021,55,1447,45,1111,0.019,10,336,0.006,58669,POINT (-87.771902 41.787032),60638-20210118
60638,01/19/2021,98,1545,61,1172,0.02,37,373,0.006,58669,POINT (-87.771902 41.787032),60638-20210119
60638,01/20/2021,126,1671,85,1257,0.021,41,414,0.007,58669,POINT (-87.771902 41.787032),60638-20210120
60638,01/21/2021,150,1821,125,1382,0.024,25,439,0.007,58669,POINT (-87.771902 41.787032),60638-20210121
60638,01/22/2021,161,1982,147,1529,0.026,14,453,0.008,58669,POINT (-87.771902 41.787032),60638-20210122
60638,01/23/2021,110,2092,107,1636,0.028,3,456,0.008,58669,POINT (-87.771902 41.787032),60638-20210123
60638,01/24/2021,33,2125,31,1667,0.028,2,458,0.008,58669,POINT (-87.771902 41.787032),60638-20210124
60638,01/25/2021,115,2240,80,1747,0.03,35,493,0.008,58669,POINT (-87.771902 41.787032),60638-20210125
60638,01/26/2021,146,2386,100,1847,0.031,46,539,0.009,58669,POINT (-87.771902 41.787032),60638-20210126
60638,01/27/2021,203,2589,177,2024,0.034,26,565,0.01,58669,POINT (-87.771902 41.787032),60638-20210127
60638,01/28/2021,211,2800,180,2204,0.038,31,596,0.01,58669,POINT (-87.771902 41.787032),60638-20210128
60638,01/29/2021,235,3035,212,2416,0.041,23,619,0.011,58669,POINT (-87.771902 41.787032),60638-20210129
60638,01/30/2021,152,3187,132,2548,0.043,20,639,0.011,58669,POINT (-87.771902 41.787032),60638-20210130
60638,01/31/2021,27,3214,21,2569,0.044,6,645,0.011,58669,POINT (-87.771902 41.787032),60638-20210131
60638,02/01/2021,157,3371,133,2702,0.046,24,669,0.011,58669,POINT (-87.771902 41.787032),60638-20210201
60649,01/15/2021,40,990,32,883,0.019,8,107,0.002,46633,POINT (-87.571522 41.762202),60649-20210115
60652,01/16/2021,26,880,19,735,0.017,7,145,0.003,43447,POINT (-87.714238 41.745398),60652-20210116
60652,01/17/2021,6,886,5,740,0.017,1,146,0.003,43447,POINT (-87.714238 41.745398),60652-20210117
60654,12/21/2020,95,400,95,400,0.02,0,0,0,20022,POINT (-87.636354 41.892485),60654-20201221
60654,12/22/2020,82,482,82,482,0.024,0,0,0,20022,POINT (-87.636354 41.892485),60654-20201222
60655,01/15/2021,45,1432,37,1072,0.038,8,360,0.013,28569,POINT (-87.701434 41.696456),60655-20210115
60655,01/16/2021,20,1452,14,1086,0.038,6,366,0.013,28569,POINT (-87.701434 41.696456),60655-20210116
60655,01/17/2021,12,1464,12,1098,0.038,0,366,0.013,28569,POINT (-87.701434 41.696456),60655-20210117
60656,01/14/2021,45,710,34,515,0.018,11,195,0.007,28218,POINT (-87.817934 41.974566),60656-20210114
60656,01/15/2021,24,734,20,535,0.019,4,199,0.007,28218,POINT (-87.817934 41.974566),60656-20210115
60656,01/16/2021,22,756,18,553,0.02,4,203,0.007,28218,POINT (-87.817934 41.974566),60656-20210116
60656,01/17/2021,6,762,5,558,0.02,1,204,0.007,28218,POINT (-87.817934 41.974566),60656-20210117
60659,01/10/2021,11,869,3,760,0.018,8,109,0.003,42735,POINT (-87.703266 41.990803),60659-20210110
60659,01/11/2021,65,934,21,781,0.018,44,153,0.004,42735,POINT (-87.703266 41.990803),60659-20210111
60659,01/12/2021,73,1007,45,826,0.019,28,181,0.004,42735,POINT (-87.703266 41.990803),60659-20210112
60659,01/13/2021,98,1105,60,886,0.021,38,219,0.005,42735,POINT (-87.703266 41.990803),60659-20210113
60659,01/14/2021,174,1279,167,1053,0.025,7,226,0.005,42735,POINT (-87.703266 41.990803),60659-20210114
60659,01/15/2021,66,1345,61,1114,0.026,5,231,0.005,42735,POINT (-87.703266 41.990803),60659-20210115
60827,02/03/2021,8,95,6,78,0.003,2,17,0.001,28483,POINT (-87.633087 41.650765),60827-20210203
60601,01/14/2021,36,935,28,651,0.043,8,284,0.019,15083,POINT (-87.622844 41.886262),60601-20210114
60601,01/15/2021,33,968,22,673,0.045,11,295,0.02,15083,POINT (-87.622844 41.886262),60601-20210115
60601,01/16/2021,24,992,19,692,0.046,5,300,0.02,15083,POINT (-87.622844 41.886262),60601-20210116
60601,01/17/2021,13,1005,7,699,0.046,6,306,0.02,15083,POINT (-87.622844 41.886262),60601-20210117
60601,01/18/2021,31,1036,10,709,0.047,21,327,0.022,15083,POINT (-87.622844 41.886262),60601-20210118
60601,01/19/2021,43,1079,21,730,0.048,22,349,0.023,15083,POINT (-87.622844 41.886262),60601-20210119
60601,01/20/2021,55,1134,38,768,0.051,17,366,0.024,15083,POINT (-87.622844 41.886262),60601-20210120
60601,01/21/2021,98,1232,86,854,0.057,12,378,0.025,15083,POINT (-87.622844 41.886262),60601-20210121
60601,01/22/2021,119,1351,108,962,0.064,11,389,0.026,15083,POINT (-87.622844 41.886262),60601-20210122
60601,01/23/2021,30,1381,29,991,0.066,1,390,0.026,15083,POINT (-87.622844 41.886262),60601-20210123
60601,01/24/2021,10,1391,9,1000,0.066,1,391,0.026,15083,POINT (-87.622844 41.886262),60601-20210124
60601,01/25/2021,59,1450,36,1036,0.069,23,414,0.027,15083,POINT (-87.622844 41.886262),60601-20210125
60601,01/26/2021,62,1512,34,1070,0.071,28,442,0.029,15083,POINT (-87.622844 41.886262),60601-20210126
60601,01/27/2021,65,1577,51,1121,0.074,14,456,0.03,15083,POINT (-87.622844 41.886262),60601-20210127
60601,01/28/2021,87,1664,67,1188,0.079,20,476,0.032,15083,POINT (-87.622844 41.886262),60601-20210128
60601,01/29/2021,105,1769,94,1282,0.085,11,487,0.032,15083,POINT (-87.622844 41.886262),60601-20210129
60601,01/30/2021,33,1802,21,1303,0.086,12,499,0.033,15083,POINT (-87.622844 41.886262),60601-20210130
60601,01/31/2021,12,1814,9,1312,0.087,3,502,0.033,15083,POINT (-87.622844 41.886262),60601-20210131
60601,02/01/2021,35,1849,23,1335,0.089,12,514,0.034,15083,POINT (-87.622844 41.886262),60601-20210201
60601,02/02/2021,51,1900,28,1363,0.09,23,537,0.036,15083,POINT (-87.622844 41.886262),60601-20210202
60601,02/03/2021,59,1959,43,1406,0.093,16,553,0.037,15083,POINT (-87.622844 41.886262),60601-20210203
60601,02/04/2021,97,2056,81,1487,0.099,16,569,0.038,15083,POINT (-87.622844 41.886262),60601-20210204
60602,01/18/2021,7,127,5,94,0.082,2,33,0.029,1145,POINT (-87.628309 41.883136),60602-20210118
60602,01/19/2021,19,146,11,105,0.092,8,41,0.036,1145,POINT (-87.628309 41.883136),60602-20210119
60602,01/20/2021,10,156,8,113,0.099,2,43,0.038,1145,POINT (-87.628309 41.883136),60602-20210120
60602,01/21/2021,14,170,13,126,0.11,1,44,0.038,1145,POINT (-87.628309 41.883136),60602-20210121
60602,01/22/2021,22,192,22,148,0.129,0,44,0.038,1145,POINT (-87.628309 41.883136),60602-20210122
60602,01/23/2021,10,202,10,158,0.138,0,44,0.038,1145,POINT (-87.628309 41.883136),60602-20210123
60602,01/24/2021,1,203,1,159,0.139,0,44,0.038,1145,POINT (-87.628309 41.883136),60602-20210124
60602,01/25/2021,11,214,9,168,0.147,2,46,0.04,1145,POINT (-87.628309 41.883136),60602-20210125
60602,01/26/2021,15,229,9,177,0.155,6,52,0.045,1145,POINT (-87.628309 41.883136),60602-20210126
60602,01/27/2021,11,240,8,185,0.162,3,55,0.048,1145,POINT (-87.628309 41.883136),60602-20210127
60602,01/28/2021,10,250,10,195,0.17,0,55,0.048,1145,POINT (-87.628309 41.883136),60602-20210128
60602,01/29/2021,12,262,11,206,0.18,1,56,0.049,1145,POINT (-87.628309 41.883136),60602-20210129
60602,01/30/2021,13,275,11,217,0.19,2,58,0.051,1145,POINT (-87.628309 41.883136),60602-20210130
60602,01/31/2021,1,276,0,217,0.19,1,59,0.052,1145,POINT (-87.628309 41.883136),60602-20210131
60666,02/04/2021,1,14,1,14,0,0,0,0,0,POINT (-87.896371 41.979511),60666-20210204
60602,02/01/2021,13,289,12,229,0.2,1,60,0.052,1145,POINT (-87.628309 41.883136),60602-20210201
60602,02/02/2021,14,303,9,238,0.208,5,65,0.057,1145,POINT (-87.628309 41.883136),60602-20210202
60602,02/03/2021,20,323,16,254,0.222,4,69,0.06,1145,POINT (-87.628309 41.883136),60602-20210203
60602,02/04/2021,16,339,14,268,0.234,2,71,0.062,1145,POINT (-87.628309 41.883136),60602-20210204
60603,01/18/2021,3,180,3,147,0.14,0,33,0.031,1052,POINT (-87.625473 41.880112),60603-20210118
60603,01/19/2021,0,180,0,147,0.14,0,33,0.031,1052,POINT (-87.625473 41.880112),60603-20210119
60603,01/20/2021,9,189,9,156,0.148,0,33,0.031,1052,POINT (-87.625473 41.880112),60603-20210120
60603,01/21/2021,12,201,9,165,0.157,3,36,0.034,1052,POINT (-87.625473 41.880112),60603-20210121
60603,01/22/2021,23,224,23,188,0.179,0,36,0.034,1052,POINT (-87.625473 41.880112),60603-20210122
60603,01/23/2021,8,232,8,196,0.186,0,36,0.034,1052,POINT (-87.625473 41.880112),60603-20210123
60603,01/24/2021,2,234,1,197,0.187,1,37,0.035,1052,POINT (-87.625473 41.880112),60603-20210124
60603,01/25/2021,4,238,3,200,0.19,1,38,0.036,1052,POINT (-87.625473 41.880112),60603-20210125
60603,01/26/2021,6,244,4,204,0.194,2,40,0.038,1052,POINT (-87.625473 41.880112),60603-20210126
60603,01/27/2021,68,312,68,272,0.259,0,40,0.038,1052,POINT (-87.625473 41.880112),60603-20210127
60603,01/28/2021,8,320,6,278,0.264,2,42,0.04,1052,POINT (-87.625473 41.880112),60603-20210128
60603,01/29/2021,7,327,6,284,0.27,1,43,0.041,1052,POINT (-87.625473 41.880112),60603-20210129
60603,01/30/2021,9,336,8,292,0.278,1,44,0.042,1052,POINT (-87.625473 41.880112),60603-20210130
60603,01/31/2021,0,336,0,292,0.278,0,44,0.042,1052,POINT (-87.625473 41.880112),60603-20210131
60603,02/01/2021,3,339,2,294,0.279,1,45,0.043,1052,POINT (-87.625473 41.880112),60603-20210201
60603,02/02/2021,9,348,5,299,0.284,4,49,0.047,1052,POINT (-87.625473 41.880112),60603-20210202
60603,02/04/2021,9,375,4,320,0.304,5,55,0.052,1052,POINT (-87.625473 41.880112),60603-20210204
60604,01/26/2021,19,122,18,110,0.134,1,12,0.015,823,POINT (-87.629029 41.878153),60604-20210126
60604,01/27/2021,15,137,14,124,0.151,1,13,0.016,823,POINT (-87.629029 41.878153),60604-20210127
60827,02/04/2021,4,99,3,81,0.003,1,18,0.001,28483,POINT (-87.633087 41.650765),60827-20210204
60604,01/28/2021,20,157,19,143,0.174,1,14,0.017,823,POINT (-87.629029 41.878153),60604-20210128
60604,01/29/2021,21,178,19,162,0.197,2,16,0.019,823,POINT (-87.629029 41.878153),60604-20210129
60604,01/30/2021,0,178,0,162,0.197,0,16,0.019,823,POINT (-87.629029 41.878153),60604-20210130
60604,01/31/2021,2,180,1,163,0.198,1,17,0.021,823,POINT (-87.629029 41.878153),60604-20210131
60604,02/01/2021,5,185,5,168,0.204,0,17,0.021,823,POINT (-87.629029 41.878153),60604-20210201
60604,02/02/2021,8,193,7,175,0.213,1,18,0.022,823,POINT (-87.629029 41.878153),60604-20210202
60604,02/04/2021,3,203,3,184,0.224,0,19,0.023,823,POINT (-87.629029 41.878153),60604-20210204
60605,01/18/2021,93,3590,40,2316,0.08,53,1274,0.044,29060,POINT (-87.623449 41.867824),60605-20210118
60605,01/19/2021,119,3709,54,2370,0.082,65,1339,0.046,29060,POINT (-87.623449 41.867824),60605-20210119
60605,01/20/2021,125,3834,39,2409,0.083,86,1425,0.049,29060,POINT (-87.623449 41.867824),60605-20210120
60605,01/21/2021,169,4003,120,2529,0.087,49,1474,0.051,29060,POINT (-87.623449 41.867824),60605-20210121
60605,01/22/2021,209,4212,188,2717,0.093,21,1495,0.051,29060,POINT (-87.623449 41.867824),60605-20210122
60605,01/23/2021,95,4307,82,2799,0.096,13,1508,0.052,29060,POINT (-87.623449 41.867824),60605-20210123
60605,01/24/2021,31,4338,30,2829,0.097,1,1509,0.052,29060,POINT (-87.623449 41.867824),60605-20210124
60605,01/25/2021,149,4487,82,2911,0.1,67,1576,0.054,29060,POINT (-87.623449 41.867824),60605-20210125
60605,01/26/2021,130,4617,71,2982,0.103,59,1635,0.056,29060,POINT (-87.623449 41.867824),60605-20210126
60605,01/27/2021,160,4777,124,3106,0.107,36,1671,0.058,29060,POINT (-87.623449 41.867824),60605-20210127
60605,01/28/2021,199,4976,155,3261,0.112,44,1715,0.059,29060,POINT (-87.623449 41.867824),60605-20210128
60605,01/29/2021,222,5198,183,3444,0.119,39,1754,0.06,29060,POINT (-87.623449 41.867824),60605-20210129
60605,01/30/2021,69,5267,46,3490,0.12,23,1777,0.061,29060,POINT (-87.623449 41.867824),60605-20210130
60605,01/31/2021,31,5298,24,3514,0.121,7,1784,0.061,29060,POINT (-87.623449 41.867824),60605-20210131
60605,02/01/2021,106,5404,72,3586,0.123,34,1818,0.063,29060,POINT (-87.623449 41.867824),60605-20210201
60605,02/02/2021,160,5564,89,3675,0.126,71,1889,0.065,29060,POINT (-87.623449 41.867824),60605-20210202
60605,02/03/2021,139,5703,97,3772,0.13,42,1931,0.066,29060,POINT (-87.623449 41.867824),60605-20210203
60605,02/04/2021,188,5891,143,3915,0.135,45,1976,0.068,29060,POINT (-87.623449 41.867824),60605-20210204
60606,02/04/2021,23,546,19,390,0.119,4,156,0.047,3287,POINT (-87.63676 41.882634),60606-20210204
60607,01/18/2021,87,3373,45,2350,0.08,42,1023,0.035,29293,POINT (-87.652727 41.876104),60607-20210118
60607,01/19/2021,150,3523,59,2409,0.082,91,1114,0.038,29293,POINT (-87.652727 41.876104),60607-20210119
60607,01/20/2021,255,3778,125,2534,0.087,130,1244,0.042,29293,POINT (-87.652727 41.876104),60607-20210120
60607,01/21/2021,210,3988,153,2687,0.092,57,1301,0.044,29293,POINT (-87.652727 41.876104),60607-20210121
60607,01/22/2021,169,4157,149,2836,0.097,20,1321,0.045,29293,POINT (-87.652727 41.876104),60607-20210122
60607,01/23/2021,52,4209,43,2879,0.098,9,1330,0.045,29293,POINT (-87.652727 41.876104),60607-20210123
60607,01/24/2021,18,4227,16,2895,0.099,2,1332,0.045,29293,POINT (-87.652727 41.876104),60607-20210124
60607,01/25/2021,192,4419,74,2969,0.101,118,1450,0.049,29293,POINT (-87.652727 41.876104),60607-20210125
60607,01/26/2021,270,4689,206,3175,0.108,64,1514,0.052,29293,POINT (-87.652727 41.876104),60607-20210126
60607,01/27/2021,169,4858,120,3295,0.112,49,1563,0.053,29293,POINT (-87.652727 41.876104),60607-20210127
60607,01/28/2021,236,5094,149,3444,0.118,87,1650,0.056,29293,POINT (-87.652727 41.876104),60607-20210128
60607,01/29/2021,159,5253,111,3555,0.121,48,1698,0.058,29293,POINT (-87.652727 41.876104),60607-20210129
60607,01/30/2021,84,5337,54,3609,0.123,30,1728,0.059,29293,POINT (-87.652727 41.876104),60607-20210130
60607,01/31/2021,21,5358,14,3623,0.124,7,1735,0.059,29293,POINT (-87.652727 41.876104),60607-20210131
60607,02/01/2021,106,5464,72,3695,0.126,34,1769,0.06,29293,POINT (-87.652727 41.876104),60607-20210201
60607,02/02/2021,151,5615,77,3772,0.129,74,1843,0.063,29293,POINT (-87.652727 41.876104),60607-20210202
60607,02/03/2021,235,5850,156,3928,0.134,79,1922,0.066,29293,POINT (-87.652727 41.876104),60607-20210203
60607,02/04/2021,165,6015,101,4029,0.138,64,1986,0.068,29293,POINT (-87.652727 41.876104),60607-20210204
60608,01/21/2021,320,3318,255,2537,0.032,65,781,0.01,80059,POINT (-87.670366 41.849879),60608-20210121
60608,01/22/2021,245,3563,233,2770,0.035,12,793,0.01,80059,POINT (-87.670366 41.849879),60608-20210122
60608,01/23/2021,140,3703,133,2903,0.036,7,800,0.01,80059,POINT (-87.670366 41.849879),60608-20210123
60608,01/24/2021,35,3738,33,2936,0.037,2,802,0.01,80059,POINT (-87.670366 41.849879),60608-20210124
60608,01/25/2021,223,3961,154,3090,0.039,69,871,0.011,80059,POINT (-87.670366 41.849879),60608-20210125
60608,01/26/2021,195,4156,143,3233,0.04,52,923,0.012,80059,POINT (-87.670366 41.849879),60608-20210126
60608,01/27/2021,307,4463,255,3488,0.044,52,975,0.012,80059,POINT (-87.670366 41.849879),60608-20210127
60608,01/28/2021,295,4758,241,3729,0.047,54,1029,0.013,80059,POINT (-87.670366 41.849879),60608-20210128
60608,01/29/2021,356,5114,296,4025,0.05,60,1089,0.014,80059,POINT (-87.670366 41.849879),60608-20210129
60608,01/30/2021,228,5342,190,4215,0.053,38,1127,0.014,80059,POINT (-87.670366 41.849879),60608-20210130
60608,01/31/2021,34,5376,30,4245,0.053,4,1131,0.014,80059,POINT (-87.670366 41.849879),60608-20210131
60608,02/01/2021,231,5607,202,4447,0.056,29,1160,0.014,80059,POINT (-87.670366 41.849879),60608-20210201
60608,02/02/2021,321,5928,251,4698,0.059,70,1230,0.015,80059,POINT (-87.670366 41.849879),60608-20210202
60608,02/03/2021,424,6352,353,5051,0.063,71,1301,0.016,80059,POINT (-87.670366 41.849879),60608-20210203
60608,02/04/2021,326,6678,254,5305,0.066,72,1373,0.017,80059,POINT (-87.670366 41.849879),60608-20210204
60609,01/18/2021,53,1106,33,900,0.015,20,206,0.003,60939,POINT (-87.653382 41.812017),60609-20210118
60609,01/19/2021,61,1167,38,938,0.015,23,229,0.004,60939,POINT (-87.653382 41.812017),60609-20210119
60609,01/20/2021,95,1262,67,1005,0.016,28,257,0.004,60939,POINT (-87.653382 41.812017),60609-20210120
60609,01/21/2021,126,1388,104,1109,0.018,22,279,0.005,60939,POINT (-87.653382 41.812017),60609-20210121
60609,01/22/2021,109,1497,106,1215,0.02,3,282,0.005,60939,POINT (-87.653382 41.812017),60609-20210122
60609,01/23/2021,81,1578,76,1291,0.021,5,287,0.005,60939,POINT (-87.653382 41.812017),60609-20210123
60609,01/24/2021,22,1600,20,1311,0.022,2,289,0.005,60939,POINT (-87.653382 41.812017),60609-20210124
60609,01/25/2021,97,1697,78,1389,0.023,19,308,0.005,60939,POINT (-87.653382 41.812017),60609-20210125
60609,01/26/2021,112,1809,82,1471,0.024,30,338,0.006,60939,POINT (-87.653382 41.812017),60609-20210126
60609,01/27/2021,135,1944,113,1584,0.026,22,360,0.006,60939,POINT (-87.653382 41.812017),60609-20210127
60609,01/28/2021,177,2121,152,1736,0.028,25,385,0.006,60939,POINT (-87.653382 41.812017),60609-20210128
60609,01/29/2021,229,2350,206,1942,0.032,23,408,0.007,60939,POINT (-87.653382 41.812017),60609-20210129
60609,01/30/2021,88,2438,74,2016,0.033,14,422,0.007,60939,POINT (-87.653382 41.812017),60609-20210130
60609,01/31/2021,21,2459,19,2035,0.033,2,424,0.007,60939,POINT (-87.653382 41.812017),60609-20210131
60609,02/01/2021,108,2567,92,2127,0.035,16,440,0.007,60939,POINT (-87.653382 41.812017),60609-20210201
60609,02/02/2021,141,2708,106,2233,0.037,35,475,0.008,60939,POINT (-87.653382 41.812017),60609-20210202
60609,02/03/2021,276,2984,164,2397,0.039,112,587,0.01,60939,POINT (-87.653382 41.812017),60609-20210203
60609,02/04/2021,167,3151,142,2539,0.042,25,612,0.01,60939,POINT (-87.653382 41.812017),60609-20210204
60610,01/18/2021,103,2416,51,1701,0.042,52,715,0.018,40548,POINT (-87.63581 41.90455),60610-20210118
60610,01/19/2021,106,2522,58,1759,0.043,48,763,0.019,40548,POINT (-87.63581 41.90455),60610-20210119
60610,01/20/2021,172,2694,125,1884,0.046,47,810,0.02,40548,POINT (-87.63581 41.90455),60610-20210120
60610,01/21/2021,292,2986,268,2152,0.053,24,834,0.021,40548,POINT (-87.63581 41.90455),60610-20210121
60610,01/22/2021,336,3322,316,2468,0.061,20,854,0.021,40548,POINT (-87.63581 41.90455),60610-20210122
60610,01/23/2021,104,3426,94,2562,0.063,10,864,0.021,40548,POINT (-87.63581 41.90455),60610-20210123
60610,01/24/2021,41,3467,35,2597,0.064,6,870,0.021,40548,POINT (-87.63581 41.90455),60610-20210124
60610,01/25/2021,147,3614,108,2705,0.067,39,909,0.022,40548,POINT (-87.63581 41.90455),60610-20210125
60610,01/26/2021,214,3828,118,2823,0.07,96,1005,0.025,40548,POINT (-87.63581 41.90455),60610-20210126
60610,01/27/2021,173,4001,127,2950,0.073,46,1051,0.026,40548,POINT (-87.63581 41.90455),60610-20210127
60610,01/28/2021,275,4276,236,3186,0.079,39,1090,0.027,40548,POINT (-87.63581 41.90455),60610-20210128
60610,01/29/2021,284,4560,267,3453,0.085,17,1107,0.027,40548,POINT (-87.63581 41.90455),60610-20210129
60610,01/30/2021,96,4656,70,3523,0.087,26,1133,0.028,40548,POINT (-87.63581 41.90455),60610-20210130
60610,01/31/2021,31,4687,29,3552,0.088,2,1135,0.028,40548,POINT (-87.63581 41.90455),60610-20210131
60610,02/01/2021,119,4806,91,3643,0.09,28,1163,0.029,40548,POINT (-87.63581 41.90455),60610-20210201
60610,02/02/2021,218,5024,147,3790,0.093,71,1234,0.03,40548,POINT (-87.63581 41.90455),60610-20210202
60610,02/03/2021,148,5172,109,3899,0.096,39,1273,0.031,40548,POINT (-87.63581 41.90455),60610-20210203
60610,02/04/2021,265,5437,226,4125,0.102,39,1312,0.032,40548,POINT (-87.63581 41.90455),60610-20210204
60611,01/16/2021,59,4925,51,3296,0.099,8,1629,0.049,33224,POINT (-87.620291 41.894734),60611-20210116
60611,01/17/2021,43,4968,11,3307,0.1,32,1661,0.05,33224,POINT (-87.620291 41.894734),60611-20210117
60611,01/18/2021,221,5189,62,3369,0.101,159,1820,0.055,33224,POINT (-87.620291 41.894734),60611-20210118
60611,01/19/2021,154,5343,57,3426,0.103,97,1917,0.058,33224,POINT (-87.620291 41.894734),60611-20210119
60611,01/20/2021,166,5509,113,3539,0.107,53,1970,0.059,33224,POINT (-87.620291 41.894734),60611-20210120
60611,01/21/2021,441,5950,416,3955,0.119,25,1995,0.06,33224,POINT (-87.620291 41.894734),60611-20210121
60611,01/22/2021,490,6440,464,4419,0.133,26,2021,0.061,33224,POINT (-87.620291 41.894734),60611-20210122
60611,01/23/2021,135,6575,129,4548,0.137,6,2027,0.061,33224,POINT (-87.620291 41.894734),60611-20210123
60611,01/24/2021,55,6630,51,4599,0.138,4,2031,0.061,33224,POINT (-87.620291 41.894734),60611-20210124
60611,01/25/2021,165,6795,129,4728,0.142,36,2067,0.062,33224,POINT (-87.620291 41.894734),60611-20210125
60611,01/26/2021,445,7240,117,4845,0.146,328,2395,0.072,33224,POINT (-87.620291 41.894734),60611-20210126
60611,01/27/2021,205,7445,142,4987,0.15,63,2458,0.074,33224,POINT (-87.620291 41.894734),60611-20210127
60611,01/28/2021,389,7834,288,5275,0.159,101,2559,0.077,33224,POINT (-87.620291 41.894734),60611-20210128
60611,01/29/2021,352,8186,322,5597,0.168,30,2589,0.078,33224,POINT (-87.620291 41.894734),60611-20210129
60611,01/30/2021,90,8276,68,5665,0.171,22,2611,0.079,33224,POINT (-87.620291 41.894734),60611-20210130
60611,01/31/2021,36,8312,26,5691,0.171,10,2621,0.079,33224,POINT (-87.620291 41.894734),60611-20210131
60611,02/01/2021,96,8408,70,5761,0.173,26,2647,0.08,33224,POINT (-87.620291 41.894734),60611-20210201
60611,02/02/2021,260,8668,115,5876,0.177,145,2792,0.084,33224,POINT (-87.620291 41.894734),60611-20210202
60611,02/03/2021,157,8825,120,5996,0.18,37,2829,0.085,33224,POINT (-87.620291 41.894734),60611-20210203
60611,02/04/2021,310,9135,283,6279,0.189,27,2856,0.086,33224,POINT (-87.620291 41.894734),60611-20210204
60612,01/18/2021,37,1965,19,1435,0.043,18,530,0.016,33735,POINT (-87.687011 41.88004),60612-20210118
60612,01/19/2021,127,2092,46,1481,0.044,81,611,0.018,33735,POINT (-87.687011 41.88004),60612-20210119
60612,01/20/2021,217,2309,128,1609,0.048,89,700,0.021,33735,POINT (-87.687011 41.88004),60612-20210120
60612,01/21/2021,231,2540,184,1793,0.053,47,747,0.022,33735,POINT (-87.687011 41.88004),60612-20210121
60612,01/22/2021,115,2655,92,1885,0.056,23,770,0.023,33735,POINT (-87.687011 41.88004),60612-20210122
60612,01/23/2021,43,2698,39,1924,0.057,4,774,0.023,33735,POINT (-87.687011 41.88004),60612-20210123
60612,01/24/2021,5,2703,5,1929,0.057,0,774,0.023,33735,POINT (-87.687011 41.88004),60612-20210124
60612,01/25/2021,129,2832,51,1980,0.059,78,852,0.025,33735,POINT (-87.687011 41.88004),60612-20210125
60612,01/26/2021,102,2934,52,2032,0.06,50,902,0.027,33735,POINT (-87.687011 41.88004),60612-20210126
60612,01/27/2021,160,3094,126,2158,0.064,34,936,0.028,33735,POINT (-87.687011 41.88004),60612-20210127
60612,01/28/2021,176,3270,129,2287,0.068,47,983,0.029,33735,POINT (-87.687011 41.88004),60612-20210128
60612,01/29/2021,167,3437,135,2422,0.072,32,1015,0.03,33735,POINT (-87.687011 41.88004),60612-20210129
60612,01/30/2021,57,3494,46,2468,0.073,11,1026,0.03,33735,POINT (-87.687011 41.88004),60612-20210130
60612,01/31/2021,43,3537,37,2505,0.074,6,1032,0.031,33735,POINT (-87.687011 41.88004),60612-20210131
60612,02/01/2021,93,3630,77,2582,0.077,16,1048,0.031,33735,POINT (-87.687011 41.88004),60612-20210201
60612,02/02/2021,155,3785,98,2680,0.079,57,1105,0.033,33735,POINT (-87.687011 41.88004),60612-20210202
60612,02/03/2021,185,3970,116,2796,0.083,69,1174,0.035,33735,POINT (-87.687011 41.88004),60612-20210203
60612,02/04/2021,139,4109,102,2898,0.086,37,1211,0.036,33735,POINT (-87.687011 41.88004),60612-20210204
60613,01/16/2021,75,3257,62,2456,0.048,13,801,0.016,50761,POINT (-87.661343 41.953742),60613-20210116
60613,01/17/2021,39,3296,22,2478,0.049,17,818,0.016,50761,POINT (-87.661343 41.953742),60613-20210117
60613,01/18/2021,132,3428,67,2545,0.05,65,883,0.017,50761,POINT (-87.661343 41.953742),60613-20210118
60613,01/19/2021,146,3574,78,2623,0.052,68,951,0.019,50761,POINT (-87.661343 41.953742),60613-20210119
60613,01/20/2021,186,3760,115,2738,0.054,71,1022,0.02,50761,POINT (-87.661343 41.953742),60613-20210120
60613,01/21/2021,245,4005,203,2941,0.058,42,1064,0.021,50761,POINT (-87.661343 41.953742),60613-20210121
60613,01/22/2021,239,4244,213,3154,0.062,26,1090,0.021,50761,POINT (-87.661343 41.953742),60613-20210122
60613,01/23/2021,116,4360,108,3262,0.064,8,1098,0.022,50761,POINT (-87.661343 41.953742),60613-20210123
60613,01/24/2021,46,4406,41,3303,0.065,5,1103,0.022,50761,POINT (-87.661343 41.953742),60613-20210124
60613,01/25/2021,197,4603,153,3456,0.068,44,1147,0.023,50761,POINT (-87.661343 41.953742),60613-20210125
60613,01/26/2021,375,4978,240,3696,0.073,135,1282,0.025,50761,POINT (-87.661343 41.953742),60613-20210126
60613,01/27/2021,220,5198,160,3856,0.076,60,1342,0.026,50761,POINT (-87.661343 41.953742),60613-20210127
60613,01/28/2021,262,5460,214,4070,0.08,48,1390,0.027,50761,POINT (-87.661343 41.953742),60613-20210128
60613,01/29/2021,254,5714,222,4292,0.085,32,1422,0.028,50761,POINT (-87.661343 41.953742),60613-20210129
60613,01/30/2021,132,5846,103,4395,0.087,29,1451,0.029,50761,POINT (-87.661343 41.953742),60613-20210130
60613,01/31/2021,63,5909,54,4449,0.088,9,1460,0.029,50761,POINT (-87.661343 41.953742),60613-20210131
60613,02/01/2021,164,6073,108,4557,0.09,56,1516,0.03,50761,POINT (-87.661343 41.953742),60613-20210201
60613,02/02/2021,254,6327,137,4694,0.092,117,1633,0.032,50761,POINT (-87.661343 41.953742),60613-20210202
60613,02/03/2021,201,6528,143,4837,0.095,58,1691,0.033,50761,POINT (-87.661343 41.953742),60613-20210203
60613,02/04/2021,245,6773,186,5023,0.099,59,1750,0.034,50761,POINT (-87.661343 41.953742),60613-20210204
60614,01/16/2021,101,4552,79,3265,0.045,22,1287,0.018,71954,POINT (-87.652064 41.922605),60614-20210116
60614,01/17/2021,55,4607,31,3296,0.046,24,1311,0.018,71954,POINT (-87.652064 41.922605),60614-20210117
60614,01/18/2021,301,4908,228,3524,0.049,73,1384,0.019,71954,POINT (-87.652064 41.922605),60614-20210118
60614,01/19/2021,284,5192,178,3702,0.051,106,1490,0.021,71954,POINT (-87.652064 41.922605),60614-20210119
60614,01/20/2021,248,5440,162,3864,0.054,86,1576,0.022,71954,POINT (-87.652064 41.922605),60614-20210120
60614,01/21/2021,364,5804,306,4170,0.058,58,1634,0.023,71954,POINT (-87.652064 41.922605),60614-20210121
60614,01/22/2021,423,6227,383,4553,0.063,40,1674,0.023,71954,POINT (-87.652064 41.922605),60614-20210122
60614,01/23/2021,157,6384,138,4691,0.065,19,1693,0.024,71954,POINT (-87.652064 41.922605),60614-20210123
60614,01/24/2021,70,6454,64,4755,0.066,6,1699,0.024,71954,POINT (-87.652064 41.922605),60614-20210124
60614,01/25/2021,338,6792,267,5022,0.07,71,1770,0.025,71954,POINT (-87.652064 41.922605),60614-20210125
60614,01/26/2021,410,7202,223,5245,0.073,187,1957,0.027,71954,POINT (-87.652064 41.922605),60614-20210126
60614,01/27/2021,301,7503,239,5484,0.076,62,2019,0.028,71954,POINT (-87.652064 41.922605),60614-20210127
60614,01/28/2021,388,7891,330,5814,0.081,58,2077,0.029,71954,POINT (-87.652064 41.922605),60614-20210128
60614,01/29/2021,410,8301,372,6186,0.086,38,2115,0.029,71954,POINT (-87.652064 41.922605),60614-20210129
60614,01/30/2021,164,8465,125,6311,0.088,39,2154,0.03,71954,POINT (-87.652064 41.922605),60614-20210130
60614,01/31/2021,77,8542,63,6374,0.089,14,2168,0.03,71954,POINT (-87.652064 41.922605),60614-20210131
60614,02/01/2021,196,8738,140,6514,0.091,56,2224,0.031,71954,POINT (-87.652064 41.922605),60614-20210201
60614,02/02/2021,317,9055,189,6703,0.093,128,2352,0.033,71954,POINT (-87.652064 41.922605),60614-20210202
60614,02/03/2021,286,9341,213,6916,0.096,73,2425,0.034,71954,POINT (-87.652064 41.922605),60614-20210203
60614,02/04/2021,336,9677,294,7210,0.1,42,2467,0.034,71954,POINT (-87.652064 41.922605),60614-20210204
60615,01/16/2021,128,2702,33,1985,0.049,95,717,0.018,40590,POINT (-87.602725 41.801993),60615-20210116
60615,01/17/2021,82,2784,14,1999,0.049,68,785,0.019,40590,POINT (-87.602725 41.801993),60615-20210117
60615,01/18/2021,263,3047,197,2196,0.054,66,851,0.021,40590,POINT (-87.602725 41.801993),60615-20210118
60615,01/19/2021,245,3292,180,2376,0.059,65,916,0.023,40590,POINT (-87.602725 41.801993),60615-20210119
60615,01/20/2021,278,3570,160,2536,0.062,118,1034,0.025,40590,POINT (-87.602725 41.801993),60615-20210120
60615,01/21/2021,436,4006,335,2871,0.071,101,1135,0.028,40590,POINT (-87.602725 41.801993),60615-20210121
60615,01/22/2021,336,4342,256,3127,0.077,80,1215,0.03,40590,POINT (-87.602725 41.801993),60615-20210122
60615,01/23/2021,206,4548,120,3247,0.08,86,1301,0.032,40590,POINT (-87.602725 41.801993),60615-20210123
60615,01/24/2021,77,4625,75,3322,0.082,2,1303,0.032,40590,POINT (-87.602725 41.801993),60615-20210124
60615,01/25/2021,187,4812,107,3429,0.084,80,1383,0.034,40590,POINT (-87.602725 41.801993),60615-20210125
60615,01/26/2021,156,4968,110,3539,0.087,46,1429,0.035,40590,POINT (-87.602725 41.801993),60615-20210126
60615,01/27/2021,199,5167,159,3698,0.091,40,1469,0.036,40590,POINT (-87.602725 41.801993),60615-20210127
60615,01/28/2021,220,5387,168,3866,0.095,52,1521,0.037,40590,POINT (-87.602725 41.801993),60615-20210128
60615,01/29/2021,264,5651,218,4084,0.101,46,1567,0.039,40590,POINT (-87.602725 41.801993),60615-20210129
60615,01/30/2021,110,5761,84,4168,0.103,26,1593,0.039,40590,POINT (-87.602725 41.801993),60615-20210130
60615,01/31/2021,99,5860,98,4266,0.105,1,1594,0.039,40590,POINT (-87.602725 41.801993),60615-20210131
60615,02/01/2021,109,5969,73,4339,0.107,36,1630,0.04,40590,POINT (-87.602725 41.801993),60615-20210201
60615,02/02/2021,145,6114,89,4428,0.109,56,1686,0.042,40590,POINT (-87.602725 41.801993),60615-20210202
60615,02/03/2021,148,6262,114,4542,0.112,34,1720,0.042,40590,POINT (-87.602725 41.801993),60615-20210203
60615,02/04/2021,219,6481,132,4674,0.115,87,1807,0.045,40590,POINT (-87.602725 41.801993),60615-20210204
60616,01/18/2021,76,2547,36,1854,0.034,40,693,0.013,54197,POINT (-87.629531 41.844869),60616-20210118
60616,01/19/2021,120,2667,65,1919,0.035,55,748,0.014,54197,POINT (-87.629531 41.844869),60616-20210119
60616,01/20/2021,152,2819,92,2011,0.037,60,808,0.015,54197,POINT (-87.629531 41.844869),60616-20210120
60616,01/21/2021,195,3014,161,2172,0.04,34,842,0.016,54197,POINT (-87.629531 41.844869),60616-20210121
60616,01/22/2021,222,3236,196,2368,0.044,26,868,0.016,54197,POINT (-87.629531 41.844869),60616-20210122
60616,01/23/2021,112,3348,101,2469,0.046,11,879,0.016,54197,POINT (-87.629531 41.844869),60616-20210123
60616,01/24/2021,21,3369,19,2488,0.046,2,881,0.016,54197,POINT (-87.629531 41.844869),60616-20210124
60616,01/25/2021,129,3498,89,2577,0.048,40,921,0.017,54197,POINT (-87.629531 41.844869),60616-20210125
60616,01/26/2021,196,3694,132,2709,0.05,64,985,0.018,54197,POINT (-87.629531 41.844869),60616-20210126
60616,01/27/2021,231,3925,202,2911,0.054,29,1014,0.019,54197,POINT (-87.629531 41.844869),60616-20210127
60616,01/28/2021,326,4251,275,3186,0.059,51,1065,0.02,54197,POINT (-87.629531 41.844869),60616-20210128
60616,01/29/2021,253,4504,231,3417,0.063,22,1087,0.02,54197,POINT (-87.629531 41.844869),60616-20210129
60616,01/30/2021,158,4662,135,3552,0.066,23,1110,0.02,54197,POINT (-87.629531 41.844869),60616-20210130
60616,01/31/2021,26,4688,23,3575,0.066,3,1113,0.021,54197,POINT (-87.629531 41.844869),60616-20210131
60616,02/01/2021,131,4819,92,3667,0.068,39,1152,0.021,54197,POINT (-87.629531 41.844869),60616-20210201
60616,02/02/2021,305,5124,196,3863,0.071,109,1261,0.023,54197,POINT (-87.629531 41.844869),60616-20210202
60616,02/03/2021,254,5378,207,4070,0.075,47,1308,0.024,54197,POINT (-87.629531 41.844869),60616-20210203
60616,02/04/2021,294,5672,221,4291,0.079,73,1381,0.025,54197,POINT (-87.629531 41.844869),60616-20210204
60617,01/16/2021,29,1109,24,913,0.011,5,196,0.002,83553,POINT (-87.556897 41.721257),60617-20210116
60617,01/17/2021,5,1114,4,917,0.011,1,197,0.002,83553,POINT (-87.556897 41.721257),60617-20210117
60617,01/18/2021,62,1176,50,967,0.012,12,209,0.003,83553,POINT (-87.556897 41.721257),60617-20210118
60617,01/19/2021,126,1302,93,1060,0.013,33,242,0.003,83553,POINT (-87.556897 41.721257),60617-20210119
60617,01/20/2021,146,1448,113,1173,0.014,33,275,0.003,83553,POINT (-87.556897 41.721257),60617-20210120
60617,01/21/2021,259,1707,236,1409,0.017,23,298,0.004,83553,POINT (-87.556897 41.721257),60617-20210121
60617,01/22/2021,227,1934,206,1615,0.019,21,319,0.004,83553,POINT (-87.556897 41.721257),60617-20210122
60617,01/23/2021,116,2050,115,1730,0.021,1,320,0.004,83553,POINT (-87.556897 41.721257),60617-20210123
60617,01/24/2021,43,2093,43,1773,0.021,0,320,0.004,83553,POINT (-87.556897 41.721257),60617-20210124
60617,01/25/2021,122,2215,93,1866,0.022,29,349,0.004,83553,POINT (-87.556897 41.721257),60617-20210125
60617,01/26/2021,183,2398,135,2001,0.024,48,397,0.005,83553,POINT (-87.556897 41.721257),60617-20210126
60617,01/27/2021,280,2678,251,2252,0.027,29,426,0.005,83553,POINT (-87.556897 41.721257),60617-20210127
60617,01/28/2021,285,2963,263,2515,0.03,22,448,0.005,83553,POINT (-87.556897 41.721257),60617-20210128
60617,01/29/2021,358,3321,337,2852,0.034,21,469,0.006,83553,POINT (-87.556897 41.721257),60617-20210129
60617,01/30/2021,148,3469,139,2991,0.036,9,478,0.006,83553,POINT (-87.556897 41.721257),60617-20210130
60617,01/31/2021,26,3495,23,3014,0.036,3,481,0.006,83553,POINT (-87.556897 41.721257),60617-20210131
60617,02/01/2021,118,3613,106,3120,0.037,12,493,0.006,83553,POINT (-87.556897 41.721257),60617-20210201
60617,02/02/2021,206,3819,154,3274,0.039,52,545,0.007,83553,POINT (-87.556897 41.721257),60617-20210202
60617,02/03/2021,259,4078,225,3499,0.042,34,579,0.007,83553,POINT (-87.556897 41.721257),60617-20210203
60617,02/04/2021,263,4341,228,3727,0.045,35,614,0.007,83553,POINT (-87.556897 41.721257),60617-20210204
60618,01/18/2021,141,3874,80,2891,0.03,61,983,0.01,94907,POINT (-87.703343 41.946699),60618-20210118
60618,01/19/2021,183,4057,88,2979,0.031,95,1078,0.011,94907,POINT (-87.703343 41.946699),60618-20210119
60618,01/20/2021,295,4352,182,3161,0.033,113,1191,0.013,94907,POINT (-87.703343 41.946699),60618-20210120
60618,01/21/2021,313,4665,240,3401,0.036,73,1264,0.013,94907,POINT (-87.703343 41.946699),60618-20210121
60618,01/22/2021,289,4954,258,3659,0.039,31,1295,0.014,94907,POINT (-87.703343 41.946699),60618-20210122
60618,01/23/2021,134,5088,119,3778,0.04,15,1310,0.014,94907,POINT (-87.703343 41.946699),60618-20210123
60618,01/24/2021,53,5141,50,3828,0.04,3,1313,0.014,94907,POINT (-87.703343 41.946699),60618-20210124
60618,01/25/2021,278,5419,215,4043,0.043,63,1376,0.014,94907,POINT (-87.703343 41.946699),60618-20210125
60618,01/26/2021,336,5755,239,4282,0.045,97,1473,0.016,94907,POINT (-87.703343 41.946699),60618-20210126
60618,01/27/2021,350,6105,269,4551,0.048,81,1554,0.016,94907,POINT (-87.703343 41.946699),60618-20210127
60618,01/28/2021,464,6569,392,4943,0.052,72,1626,0.017,94907,POINT (-87.703343 41.946699),60618-20210128
60618,01/29/2021,339,6908,292,5235,0.055,47,1673,0.018,94907,POINT (-87.703343 41.946699),60618-20210129
60618,01/30/2021,201,7109,150,5385,0.057,51,1724,0.018,94907,POINT (-87.703343 41.946699),60618-20210130
60618,01/31/2021,95,7204,78,5463,0.058,17,1741,0.018,94907,POINT (-87.703343 41.946699),60618-20210131
60618,02/01/2021,253,7457,171,5634,0.059,82,1823,0.019,94907,POINT (-87.703343 41.946699),60618-20210201
60618,02/02/2021,391,7848,256,5890,0.062,135,1958,0.021,94907,POINT (-87.703343 41.946699),60618-20210202
60618,02/03/2021,403,8251,304,6194,0.065,99,2057,0.022,94907,POINT (-87.703343 41.946699),60618-20210203
60618,02/04/2021,340,8591,276,6470,0.068,64,2121,0.022,94907,POINT (-87.703343 41.946699),60618-20210204
60619,02/02/2021,148,3141,113,2733,0.045,35,408,0.007,61207,POINT (-87.60569 41.744737),60619-20210202
60619,02/03/2021,217,3358,180,2913,0.048,37,445,0.007,61207,POINT (-87.60569 41.744737),60619-20210203
60619,02/04/2021,196,3554,161,3074,0.05,35,480,0.008,61207,POINT (-87.60569 41.744737),60619-20210204
60620,01/21/2021,124,1201,104,995,0.015,20,206,0.003,67711,POINT (-87.651656 41.740873),60620-20210121
60620,01/22/2021,96,1297,87,1082,0.016,9,215,0.003,67711,POINT (-87.651656 41.740873),60620-20210122
60620,01/23/2021,63,1360,58,1140,0.017,5,220,0.003,67711,POINT (-87.651656 41.740873),60620-20210123
60620,01/24/2021,27,1387,27,1167,0.017,0,220,0.003,67711,POINT (-87.651656 41.740873),60620-20210124
60620,01/25/2021,104,1491,83,1250,0.018,21,241,0.004,67711,POINT (-87.651656 41.740873),60620-20210125
60620,01/26/2021,112,1603,80,1330,0.02,32,273,0.004,67711,POINT (-87.651656 41.740873),60620-20210126
60620,01/27/2021,130,1733,106,1436,0.021,24,297,0.004,67711,POINT (-87.651656 41.740873),60620-20210127
60620,01/28/2021,162,1895,140,1576,0.023,22,319,0.005,67711,POINT (-87.651656 41.740873),60620-20210128
60620,01/29/2021,209,2104,177,1753,0.026,32,351,0.005,67711,POINT (-87.651656 41.740873),60620-20210129
60620,01/30/2021,94,2198,80,1833,0.027,14,365,0.005,67711,POINT (-87.651656 41.740873),60620-20210130
60620,01/31/2021,13,2211,13,1846,0.027,0,365,0.005,67711,POINT (-87.651656 41.740873),60620-20210131
60620,02/01/2021,129,2340,114,1960,0.029,15,380,0.006,67711,POINT (-87.651656 41.740873),60620-20210201
60620,02/02/2021,141,2481,114,2074,0.031,27,407,0.006,67711,POINT (-87.651656 41.740873),60620-20210202
60620,02/03/2021,313,2794,198,2272,0.034,115,522,0.008,67711,POINT (-87.651656 41.740873),60620-20210203
60620,02/04/2021,199,2993,181,2453,0.036,18,540,0.008,67711,POINT (-87.651656 41.740873),60620-20210204
60621,02/04/2021,58,1135,48,929,0.033,10,206,0.007,28018,POINT (-87.638812 41.776931),60621-20210204
60622,01/16/2021,82,4665,76,3391,0.064,6,1274,0.024,53294,POINT (-87.681818 41.902762),60622-20210116
60622,01/17/2021,30,4695,14,3405,0.064,16,1290,0.024,53294,POINT (-87.681818 41.902762),60622-20210117
60622,01/18/2021,122,4817,74,3479,0.065,48,1338,0.025,53294,POINT (-87.681818 41.902762),60622-20210118
60622,01/19/2021,153,4970,62,3541,0.066,91,1429,0.027,53294,POINT (-87.681818 41.902762),60622-20210119
60622,01/20/2021,254,5224,144,3685,0.069,110,1539,0.029,53294,POINT (-87.681818 41.902762),60622-20210120
60622,01/21/2021,333,5557,256,3941,0.074,77,1616,0.03,53294,POINT (-87.681818 41.902762),60622-20210121
60622,01/22/2021,219,5776,182,4123,0.077,37,1653,0.031,53294,POINT (-87.681818 41.902762),60622-20210122
60622,01/23/2021,90,5866,85,4208,0.079,5,1658,0.031,53294,POINT (-87.681818 41.902762),60622-20210123
60622,01/24/2021,36,5902,34,4242,0.08,2,1660,0.031,53294,POINT (-87.681818 41.902762),60622-20210124
60622,01/25/2021,153,6055,87,4329,0.081,66,1726,0.032,53294,POINT (-87.681818 41.902762),60622-20210125
60622,01/26/2021,235,6290,119,4448,0.083,116,1842,0.035,53294,POINT (-87.681818 41.902762),60622-20210126
60622,01/27/2021,219,6509,149,4597,0.086,70,1912,0.036,53294,POINT (-87.681818 41.902762),60622-20210127
60622,01/28/2021,287,6796,213,4810,0.09,74,1986,0.037,53294,POINT (-87.681818 41.902762),60622-20210128
60622,01/29/2021,240,7036,172,4982,0.093,68,2054,0.039,53294,POINT (-87.681818 41.902762),60622-20210129
60622,01/30/2021,128,7164,91,5073,0.095,37,2091,0.039,53294,POINT (-87.681818 41.902762),60622-20210130
60622,01/31/2021,44,7208,34,5107,0.096,10,2101,0.039,53294,POINT (-87.681818 41.902762),60622-20210131
60622,02/01/2021,151,7359,117,5224,0.098,34,2135,0.04,53294,POINT (-87.681818 41.902762),60622-20210201
60622,02/02/2021,263,7622,161,5385,0.101,102,2237,0.042,53294,POINT (-87.681818 41.902762),60622-20210202
60622,02/03/2021,267,7889,164,5549,0.104,103,2340,0.044,53294,POINT (-87.681818 41.902762),60622-20210203
60622,02/04/2021,229,8118,185,5734,0.108,44,2384,0.045,53294,POINT (-87.681818 41.902762),60622-20210204
60623,01/22/2021,178,1666,173,1427,0.018,5,239,0.003,81283,POINT (-87.717446 41.850321),60623-20210122
60623,01/23/2021,70,1736,68,1495,0.018,2,241,0.003,81283,POINT (-87.717446 41.850321),60623-20210123
60623,01/24/2021,10,1746,8,1503,0.018,2,243,0.003,81283,POINT (-87.717446 41.850321),60623-20210124
60623,01/25/2021,114,1860,80,1583,0.019,34,277,0.003,81283,POINT (-87.717446 41.850321),60623-20210125
60623,01/26/2021,122,1982,103,1686,0.021,19,296,0.004,81283,POINT (-87.717446 41.850321),60623-20210126
60623,01/27/2021,250,2232,161,1847,0.023,89,385,0.005,81283,POINT (-87.717446 41.850321),60623-20210127
60623,01/28/2021,191,2423,149,1996,0.025,42,427,0.005,81283,POINT (-87.717446 41.850321),60623-20210128
60623,01/29/2021,218,2641,195,2191,0.027,23,450,0.006,81283,POINT (-87.717446 41.850321),60623-20210129
60623,01/30/2021,87,2728,72,2263,0.028,15,465,0.006,81283,POINT (-87.717446 41.850321),60623-20210130
60623,01/31/2021,11,2739,10,2273,0.028,1,466,0.006,81283,POINT (-87.717446 41.850321),60623-20210131
60623,02/01/2021,193,2932,171,2444,0.03,22,488,0.006,81283,POINT (-87.717446 41.850321),60623-20210201
60623,02/02/2021,219,3151,189,2633,0.032,30,518,0.006,81283,POINT (-87.717446 41.850321),60623-20210202
60623,02/03/2021,400,3551,306,2939,0.036,94,612,0.008,81283,POINT (-87.717446 41.850321),60623-20210203
60623,02/04/2021,254,3805,215,3154,0.039,39,651,0.008,81283,POINT (-87.717446 41.850321),60623-20210204
60624,02/03/2021,105,1339,90,1127,0.032,15,212,0.006,34892,POINT (-87.722735 41.879417),60624-20210203
60624,02/04/2021,75,1414,66,1193,0.034,9,221,0.006,34892,POINT (-87.722735 41.879417),60624-20210204
60625,01/06/2021,176,1602,164,1583,0.02,12,19,0,79444,POINT (-87.701816 41.971155),60625-20210106
60625,01/07/2021,137,1739,71,1654,0.021,66,85,0.001,79444,POINT (-87.701816 41.971155),60625-20210107
60625,01/08/2021,233,1972,86,1740,0.022,147,232,0.003,79444,POINT (-87.701816 41.971155),60625-20210108
60625,01/09/2021,107,2079,44,1784,0.022,63,295,0.004,79444,POINT (-87.701816 41.971155),60625-20210109
60625,01/10/2021,20,2099,12,1796,0.023,8,303,0.004,79444,POINT (-87.701816 41.971155),60625-20210110
60625,01/11/2021,173,2272,54,1850,0.023,119,422,0.005,79444,POINT (-87.701816 41.971155),60625-20210111
60625,01/12/2021,174,2446,120,1970,0.025,54,476,0.006,79444,POINT (-87.701816 41.971155),60625-20210112
60625,01/13/2021,192,2638,91,2061,0.026,101,577,0.007,79444,POINT (-87.701816 41.971155),60625-20210113
60625,01/14/2021,101,2739,84,2145,0.027,17,594,0.007,79444,POINT (-87.701816 41.971155),60625-20210114
60625,01/15/2021,104,2843,97,2242,0.028,7,601,0.008,79444,POINT (-87.701816 41.971155),60625-20210115
60625,01/16/2021,83,2926,75,2317,0.029,8,609,0.008,79444,POINT (-87.701816 41.971155),60625-20210116
60625,01/17/2021,45,2971,31,2348,0.03,14,623,0.008,79444,POINT (-87.701816 41.971155),60625-20210117
60625,01/18/2021,117,3088,78,2426,0.031,39,662,0.008,79444,POINT (-87.701816 41.971155),60625-20210118
60625,01/19/2021,125,3213,75,2501,0.031,50,712,0.009,79444,POINT (-87.701816 41.971155),60625-20210119
60625,01/20/2021,277,3490,194,2695,0.034,83,795,0.01,79444,POINT (-87.701816 41.971155),60625-20210120
60625,01/21/2021,390,3880,302,2997,0.038,88,883,0.011,79444,POINT (-87.701816 41.971155),60625-20210121
60625,01/22/2021,220,4100,202,3199,0.04,18,901,0.011,79444,POINT (-87.701816 41.971155),60625-20210122
60625,01/23/2021,114,4214,103,3302,0.042,11,912,0.011,79444,POINT (-87.701816 41.971155),60625-20210123
60625,01/24/2021,55,4269,48,3350,0.042,7,919,0.012,79444,POINT (-87.701816 41.971155),60625-20210124
60625,01/25/2021,238,4507,155,3505,0.044,83,1002,0.013,79444,POINT (-87.701816 41.971155),60625-20210125
60625,01/26/2021,237,4744,158,3663,0.046,79,1081,0.014,79444,POINT (-87.701816 41.971155),60625-20210126
60625,01/27/2021,346,5090,249,3912,0.049,97,1178,0.015,79444,POINT (-87.701816 41.971155),60625-20210127
60625,01/28/2021,261,5351,211,4123,0.052,50,1228,0.015,79444,POINT (-87.701816 41.971155),60625-20210128
60625,01/29/2021,264,5615,238,4361,0.055,26,1254,0.016,79444,POINT (-87.701816 41.971155),60625-20210129
60625,01/30/2021,224,5839,193,4554,0.057,31,1285,0.016,79444,POINT (-87.701816 41.971155),60625-20210130
60625,01/31/2021,128,5967,104,4658,0.059,24,1309,0.016,79444,POINT (-87.701816 41.971155),60625-20210131
60625,02/01/2021,209,6176,154,4812,0.061,55,1364,0.017,79444,POINT (-87.701816 41.971155),60625-20210201
60625,02/02/2021,314,6490,219,5031,0.063,95,1459,0.018,79444,POINT (-87.701816 41.971155),60625-20210202
60625,02/03/2021,365,6855,252,5283,0.066,113,1572,0.02,79444,POINT (-87.701816 41.971155),60625-20210203
60625,02/04/2021,283,7138,239,5522,0.07,44,1616,0.02,79444,POINT (-87.701816 41.971155),60625-20210204
60626,01/08/2021,149,1328,71,1206,0.024,78,122,0.002,50544,POINT (-87.669834 42.009469),60626-20210108
60626,01/09/2021,65,1393,31,1237,0.024,34,156,0.003,50544,POINT (-87.669834 42.009469),60626-20210109
60626,01/10/2021,12,1405,4,1241,0.025,8,164,0.003,50544,POINT (-87.669834 42.009469),60626-20210110
60626,01/11/2021,90,1495,41,1282,0.025,49,213,0.004,50544,POINT (-87.669834 42.009469),60626-20210111
60626,01/12/2021,191,1686,156,1438,0.028,35,248,0.005,50544,POINT (-87.669834 42.009469),60626-20210112
60626,01/13/2021,92,1778,54,1492,0.03,38,286,0.006,50544,POINT (-87.669834 42.009469),60626-20210113
60626,01/14/2021,268,2046,257,1749,0.035,11,297,0.006,50544,POINT (-87.669834 42.009469),60626-20210114
60626,01/15/2021,260,2306,250,1999,0.04,10,307,0.006,50544,POINT (-87.669834 42.009469),60626-20210115
60626,01/16/2021,51,2357,47,2046,0.04,4,311,0.006,50544,POINT (-87.669834 42.009469),60626-20210116
60626,01/17/2021,19,2376,12,2058,0.041,7,318,0.006,50544,POINT (-87.669834 42.009469),60626-20210117
60626,01/18/2021,235,2611,218,2276,0.045,17,335,0.007,50544,POINT (-87.669834 42.009469),60626-20210118
60626,01/19/2021,93,2704,56,2332,0.046,37,372,0.007,50544,POINT (-87.669834 42.009469),60626-20210119
60626,01/20/2021,143,2847,112,2444,0.048,31,403,0.008,50544,POINT (-87.669834 42.009469),60626-20210120
60626,01/21/2021,179,3026,146,2590,0.051,33,436,0.009,50544,POINT (-87.669834 42.009469),60626-20210121
60626,01/22/2021,147,3173,139,2729,0.054,8,444,0.009,50544,POINT (-87.669834 42.009469),60626-20210122
60626,01/23/2021,66,3239,64,2793,0.055,2,446,0.009,50544,POINT (-87.669834 42.009469),60626-20210123
60626,01/24/2021,25,3264,23,2816,0.056,2,448,0.009,50544,POINT (-87.669834 42.009469),60626-20210124
60626,01/25/2021,112,3376,77,2893,0.057,35,483,0.01,50544,POINT (-87.669834 42.009469),60626-20210125
60626,01/26/2021,150,3526,95,2988,0.059,55,538,0.011,50544,POINT (-87.669834 42.009469),60626-20210126
60626,01/27/2021,426,3952,168,3156,0.062,258,796,0.016,50544,POINT (-87.669834 42.009469),60626-20210127
60626,01/28/2021,156,4108,127,3283,0.065,29,825,0.016,50544,POINT (-87.669834 42.009469),60626-20210128
60626,01/29/2021,151,4259,139,3422,0.068,12,837,0.017,50544,POINT (-87.669834 42.009469),60626-20210129
60626,01/30/2021,99,4358,87,3509,0.069,12,849,0.017,50544,POINT (-87.669834 42.009469),60626-20210130
60626,01/31/2021,44,4402,30,3539,0.07,14,863,0.017,50544,POINT (-87.669834 42.009469),60626-20210131
60626,02/01/2021,146,4548,103,3642,0.072,43,906,0.018,50544,POINT (-87.669834 42.009469),60626-20210201
60626,02/02/2021,239,4787,139,3781,0.075,100,1006,0.02,50544,POINT (-87.669834 42.009469),60626-20210202
60626,02/03/2021,172,4959,112,3893,0.077,60,1066,0.021,50544,POINT (-87.669834 42.009469),60626-20210203
60626,02/04/2021,160,5119,121,4014,0.079,39,1105,0.022,50544,POINT (-87.669834 42.009469),60626-20210204
60628,01/20/2021,135,1043,108,872,0.014,27,171,0.003,64254,POINT (-87.621537 41.694192),60628-20210120
60628,01/21/2021,95,1138,84,956,0.015,11,182,0.003,64254,POINT (-87.621537 41.694192),60628-20210121
60628,01/22/2021,108,1246,101,1057,0.016,7,189,0.003,64254,POINT (-87.621537 41.694192),60628-20210122
60628,01/23/2021,58,1304,58,1115,0.017,0,189,0.003,64254,POINT (-87.621537 41.694192),60628-20210123
60628,01/24/2021,31,1335,31,1146,0.018,0,189,0.003,64254,POINT (-87.621537 41.694192),60628-20210124
60628,01/25/2021,99,1434,79,1225,0.019,20,209,0.003,64254,POINT (-87.621537 41.694192),60628-20210125
60628,01/26/2021,109,1543,92,1317,0.02,17,226,0.004,64254,POINT (-87.621537 41.694192),60628-20210126
60628,01/27/2021,155,1698,144,1461,0.023,11,237,0.004,64254,POINT (-87.621537 41.694192),60628-20210127
60628,01/28/2021,174,1872,163,1624,0.025,11,248,0.004,64254,POINT (-87.621537 41.694192),60628-20210128
60628,01/29/2021,205,2077,187,1811,0.028,18,266,0.004,64254,POINT (-87.621537 41.694192),60628-20210129
60628,01/30/2021,102,2179,95,1906,0.03,7,273,0.004,64254,POINT (-87.621537 41.694192),60628-20210130
60628,01/31/2021,13,2192,10,1916,0.03,3,276,0.004,64254,POINT (-87.621537 41.694192),60628-20210131
60628,02/01/2021,215,2407,95,2011,0.031,120,396,0.006,64254,POINT (-87.621537 41.694192),60628-20210201
60628,02/02/2021,164,2571,138,2149,0.033,26,422,0.007,64254,POINT (-87.621537 41.694192),60628-20210202
60628,02/03/2021,157,2728,126,2275,0.035,31,453,0.007,64254,POINT (-87.621537 41.694192),60628-20210203
60628,02/04/2021,185,2913,164,2439,0.038,21,474,0.007,64254,POINT (-87.621537 41.694192),60628-20210204
60629,01/15/2021,58,1371,52,1117,0.01,6,254,0.002,110029,POINT (-87.711565 41.777061),60629-20210115
60629,01/16/2021,128,1499,118,1235,0.011,10,264,0.002,110029,POINT (-87.711565 41.777061),60629-20210116
60629,01/17/2021,9,1508,6,1241,0.011,3,267,0.002,110029,POINT (-87.711565 41.777061),60629-20210117
60629,01/18/2021,48,1556,30,1271,0.012,18,285,0.003,110029,POINT (-87.711565 41.777061),60629-20210118
60629,01/19/2021,109,1665,63,1334,0.012,46,331,0.003,110029,POINT (-87.711565 41.777061),60629-20210119
60629,01/20/2021,143,1808,95,1429,0.013,48,379,0.003,110029,POINT (-87.711565 41.777061),60629-20210120
60629,01/21/2021,239,2047,216,1645,0.015,23,402,0.004,110029,POINT (-87.711565 41.777061),60629-20210121
60629,01/22/2021,183,2230,173,1818,0.017,10,412,0.004,110029,POINT (-87.711565 41.777061),60629-20210122
60629,01/23/2021,80,2310,74,1892,0.017,6,418,0.004,110029,POINT (-87.711565 41.777061),60629-20210123
60629,01/24/2021,20,2330,19,1911,0.017,1,419,0.004,110029,POINT (-87.711565 41.777061),60629-20210124
60629,01/25/2021,134,2464,106,2017,0.018,28,447,0.004,110029,POINT (-87.711565 41.777061),60629-20210125
60629,01/26/2021,181,2645,129,2146,0.02,52,499,0.005,110029,POINT (-87.711565 41.777061),60629-20210126
60629,01/27/2021,219,2864,188,2334,0.021,31,530,0.005,110029,POINT (-87.711565 41.777061),60629-20210127
60629,01/28/2021,231,3095,190,2524,0.023,41,571,0.005,110029,POINT (-87.711565 41.777061),60629-20210128
60629,01/29/2021,315,3410,286,2810,0.026,29,600,0.005,110029,POINT (-87.711565 41.777061),60629-20210129
60629,01/30/2021,166,3576,140,2950,0.027,26,626,0.006,110029,POINT (-87.711565 41.777061),60629-20210130
60629,01/31/2021,24,3600,18,2968,0.027,6,632,0.006,110029,POINT (-87.711565 41.777061),60629-20210131
60629,02/01/2021,199,3799,169,3137,0.029,30,662,0.006,110029,POINT (-87.711565 41.777061),60629-20210201
60629,02/02/2021,265,4064,214,3351,0.03,51,713,0.006,110029,POINT (-87.711565 41.777061),60629-20210202
60629,02/03/2021,367,4431,300,3651,0.033,67,780,0.007,110029,POINT (-87.711565 41.777061),60629-20210203
60629,02/04/2021,310,4741,260,3911,0.036,50,830,0.008,110029,POINT (-87.711565 41.777061),60629-20210204
60630,01/16/2021,68,1894,62,1480,0.026,6,414,0.007,56433,POINT (-87.759611 41.971261),60630-20210116
60630,01/17/2021,20,1914,13,1493,0.026,7,421,0.007,56433,POINT (-87.759611 41.971261),60630-20210117
60630,01/18/2021,64,1978,36,1529,0.027,28,449,0.008,56433,POINT (-87.759611 41.971261),60630-20210118
60630,01/19/2021,81,2059,49,1578,0.028,32,481,0.009,56433,POINT (-87.759611 41.971261),60630-20210119
60630,01/20/2021,132,2191,85,1663,0.029,47,528,0.009,56433,POINT (-87.759611 41.971261),60630-20210120
60630,01/21/2021,163,2354,129,1792,0.032,34,562,0.01,56433,POINT (-87.759611 41.971261),60630-20210121
60630,01/22/2021,154,2508,138,1930,0.034,16,578,0.01,56433,POINT (-87.759611 41.971261),60630-20210122
60630,01/23/2021,103,2611,97,2027,0.036,6,584,0.01,56433,POINT (-87.759611 41.971261),60630-20210123
60630,01/24/2021,27,2638,22,2049,0.036,5,589,0.01,56433,POINT (-87.759611 41.971261),60630-20210124
60630,01/25/2021,130,2768,97,2146,0.038,33,622,0.011,56433,POINT (-87.759611 41.971261),60630-20210125
60630,01/26/2021,148,2916,99,2245,0.04,49,671,0.012,56433,POINT (-87.759611 41.971261),60630-20210126
60630,01/27/2021,201,3117,159,2404,0.043,42,713,0.013,56433,POINT (-87.759611 41.971261),60630-20210127
60630,01/28/2021,202,3319,161,2565,0.045,41,754,0.013,56433,POINT (-87.759611 41.971261),60630-20210128
60630,01/29/2021,178,3497,155,2720,0.048,23,777,0.014,56433,POINT (-87.759611 41.971261),60630-20210129
60630,01/30/2021,134,3631,121,2841,0.05,13,790,0.014,56433,POINT (-87.759611 41.971261),60630-20210130
60630,01/31/2021,56,3687,50,2891,0.051,6,796,0.014,56433,POINT (-87.759611 41.971261),60630-20210131
60630,02/01/2021,152,3839,105,2996,0.053,47,843,0.015,56433,POINT (-87.759611 41.971261),60630-20210201
60630,02/02/2021,305,4144,184,3180,0.056,121,964,0.017,56433,POINT (-87.759611 41.971261),60630-20210202
60630,02/03/2021,233,4377,172,3352,0.059,61,1025,0.018,56433,POINT (-87.759611 41.971261),60630-20210203
60630,02/04/2021,219,4596,183,3535,0.063,36,1061,0.019,56433,POINT (-87.759611 41.971261),60630-20210204
60631,01/06/2021,55,775,37,755,0.026,18,20,0.001,29529,POINT (-87.813371 41.995019),60631-20210106
60631,01/07/2021,98,873,37,792,0.027,61,81,0.003,29529,POINT (-87.813371 41.995019),60631-20210107
60631,01/08/2021,181,1054,110,902,0.031,71,152,0.005,29529,POINT (-87.813371 41.995019),60631-20210108
60631,01/09/2021,65,1119,10,912,0.031,55,207,0.007,29529,POINT (-87.813371 41.995019),60631-20210109
60631,01/10/2021,18,1137,1,913,0.031,17,224,0.008,29529,POINT (-87.813371 41.995019),60631-20210110
60631,01/11/2021,54,1191,15,928,0.031,39,263,0.009,29529,POINT (-87.813371 41.995019),60631-20210111
60631,01/12/2021,62,1253,35,963,0.033,27,290,0.01,29529,POINT (-87.813371 41.995019),60631-20210112
60631,01/13/2021,79,1332,57,1020,0.035,22,312,0.011,29529,POINT (-87.813371 41.995019),60631-20210113
60631,01/14/2021,53,1385,44,1064,0.036,9,321,0.011,29529,POINT (-87.813371 41.995019),60631-20210114
60631,01/15/2021,43,1428,38,1102,0.037,5,326,0.011,29529,POINT (-87.813371 41.995019),60631-20210115
60631,01/16/2021,91,1519,87,1189,0.04,4,330,0.011,29529,POINT (-87.813371 41.995019),60631-20210116
60631,01/17/2021,42,1561,38,1227,0.042,4,334,0.011,29529,POINT (-87.813371 41.995019),60631-20210117
60631,01/18/2021,35,1596,29,1256,0.043,6,340,0.012,29529,POINT (-87.813371 41.995019),60631-20210118
60631,01/19/2021,95,1691,78,1334,0.045,17,357,0.012,29529,POINT (-87.813371 41.995019),60631-20210119
60631,01/20/2021,119,1810,91,1425,0.048,28,385,0.013,29529,POINT (-87.813371 41.995019),60631-20210120
60631,01/21/2021,112,1922,101,1526,0.052,11,396,0.013,29529,POINT (-87.813371 41.995019),60631-20210121
60631,01/22/2021,117,2039,104,1630,0.055,13,409,0.014,29529,POINT (-87.813371 41.995019),60631-20210122
60631,01/23/2021,76,2115,71,1701,0.058,5,414,0.014,29529,POINT (-87.813371 41.995019),60631-20210123
60631,01/24/2021,25,2140,21,1722,0.058,4,418,0.014,29529,POINT (-87.813371 41.995019),60631-20210124
60631,01/25/2021,102,2242,75,1797,0.061,27,445,0.015,29529,POINT (-87.813371 41.995019),60631-20210125
60631,01/26/2021,100,2342,73,1870,0.063,27,472,0.016,29529,POINT (-87.813371 41.995019),60631-20210126
60631,01/27/2021,155,2497,122,1992,0.067,33,505,0.017,29529,POINT (-87.813371 41.995019),60631-20210127
60631,01/28/2021,150,2647,124,2116,0.072,26,531,0.018,29529,POINT (-87.813371 41.995019),60631-20210128
60631,01/29/2021,142,2789,122,2238,0.076,20,551,0.019,29529,POINT (-87.813371 41.995019),60631-20210129
60631,01/30/2021,163,2952,100,2338,0.079,63,614,0.021,29529,POINT (-87.813371 41.995019),60631-20210130
60631,01/31/2021,30,2982,24,2362,0.08,6,620,0.021,29529,POINT (-87.813371 41.995019),60631-20210131
60631,02/01/2021,113,3095,82,2444,0.083,31,651,0.022,29529,POINT (-87.813371 41.995019),60631-20210201
60631,02/02/2021,157,3252,115,2559,0.087,42,693,0.023,29529,POINT (-87.813371 41.995019),60631-20210202
60631,02/03/2021,188,3440,149,2708,0.092,39,732,0.025,29529,POINT (-87.813371 41.995019),60631-20210203
60631,02/04/2021,147,3587,133,2841,0.096,14,746,0.025,29529,POINT (-87.813371 41.995019),60631-20210204
60632,01/18/2021,53,1114,34,942,0.01,19,172,0.002,89857,POINT (-87.711251 41.810038),60632-20210118
60632,01/19/2021,94,1208,61,1003,0.011,33,205,0.002,89857,POINT (-87.711251 41.810038),60632-20210119
60632,01/20/2021,152,1360,114,1117,0.012,38,243,0.003,89857,POINT (-87.711251 41.810038),60632-20210120
60632,01/21/2021,127,1487,109,1226,0.014,18,261,0.003,89857,POINT (-87.711251 41.810038),60632-20210121
60632,01/22/2021,123,1610,114,1340,0.015,9,270,0.003,89857,POINT (-87.711251 41.810038),60632-20210122
60632,01/23/2021,87,1697,85,1425,0.016,2,272,0.003,89857,POINT (-87.711251 41.810038),60632-20210123
60632,01/24/2021,15,1712,14,1439,0.016,1,273,0.003,89857,POINT (-87.711251 41.810038),60632-20210124
60632,01/25/2021,119,1831,89,1528,0.017,30,303,0.003,89857,POINT (-87.711251 41.810038),60632-20210125
60632,01/26/2021,136,1967,101,1629,0.018,35,338,0.004,89857,POINT (-87.711251 41.810038),60632-20210126
60632,01/27/2021,271,2238,211,1840,0.02,60,398,0.004,89857,POINT (-87.711251 41.810038),60632-20210127
60632,01/28/2021,232,2470,196,2036,0.023,36,434,0.005,89857,POINT (-87.711251 41.810038),60632-20210128
60632,01/29/2021,287,2757,257,2293,0.026,30,464,0.005,89857,POINT (-87.711251 41.810038),60632-20210129
60632,01/30/2021,159,2916,143,2436,0.027,16,480,0.005,89857,POINT (-87.711251 41.810038),60632-20210130
60632,01/31/2021,19,2935,19,2455,0.027,0,480,0.005,89857,POINT (-87.711251 41.810038),60632-20210131
60632,02/01/2021,200,3135,176,2631,0.029,24,504,0.006,89857,POINT (-87.711251 41.810038),60632-20210201
60632,02/02/2021,279,3414,236,2867,0.032,43,547,0.006,89857,POINT (-87.711251 41.810038),60632-20210202
60632,02/03/2021,363,3777,327,3194,0.036,36,583,0.006,89857,POINT (-87.711251 41.810038),60632-20210203
60632,02/04/2021,319,4096,284,3478,0.039,35,618,0.007,89857,POINT (-87.711251 41.810038),60632-20210204
60633,02/02/2021,30,450,26,374,0.029,4,76,0.006,12689,POINT (-87.556037 41.653147),60633-20210202
60633,02/03/2021,32,482,30,404,0.032,2,78,0.006,12689,POINT (-87.556037 41.653147),60633-20210203
60633,02/04/2021,22,504,15,419,0.033,7,85,0.007,12689,POINT (-87.556037 41.653147),60633-20210204
60634,01/16/2021,152,2451,144,2025,0.027,8,426,0.006,75082,POINT (-87.797373 41.944967),60634-20210116
60634,01/17/2021,23,2474,11,2036,0.027,12,438,0.006,75082,POINT (-87.797373 41.944967),60634-20210117
60634,01/18/2021,58,2532,42,2078,0.028,16,454,0.006,75082,POINT (-87.797373 41.944967),60634-20210118
60634,01/19/2021,119,2651,71,2149,0.029,48,502,0.007,75082,POINT (-87.797373 41.944967),60634-20210119
60634,01/20/2021,212,2863,162,2311,0.031,50,552,0.007,75082,POINT (-87.797373 41.944967),60634-20210120
60634,01/21/2021,173,3036,134,2445,0.033,39,591,0.008,75082,POINT (-87.797373 41.944967),60634-20210121
60634,01/22/2021,162,3198,150,2595,0.035,12,603,0.008,75082,POINT (-87.797373 41.944967),60634-20210122
60634,01/23/2021,93,3291,80,2675,0.036,13,616,0.008,75082,POINT (-87.797373 41.944967),60634-20210123
60634,01/24/2021,37,3328,31,2706,0.036,6,622,0.008,75082,POINT (-87.797373 41.944967),60634-20210124
60634,01/25/2021,187,3515,138,2844,0.038,49,671,0.009,75082,POINT (-87.797373 41.944967),60634-20210125
60634,01/26/2021,173,3688,108,2952,0.039,65,736,0.01,75082,POINT (-87.797373 41.944967),60634-20210126
60634,01/27/2021,210,3898,156,3108,0.041,54,790,0.011,75082,POINT (-87.797373 41.944967),60634-20210127
60634,01/28/2021,260,4158,199,3307,0.044,61,851,0.011,75082,POINT (-87.797373 41.944967),60634-20210128
60634,01/29/2021,190,4348,167,3474,0.046,23,874,0.012,75082,POINT (-87.797373 41.944967),60634-20210129
60634,01/30/2021,222,4570,131,3605,0.048,91,965,0.013,75082,POINT (-87.797373 41.944967),60634-20210130
60634,01/31/2021,51,4621,44,3649,0.049,7,972,0.013,75082,POINT (-87.797373 41.944967),60634-20210131
60634,02/01/2021,175,4796,128,3777,0.05,47,1019,0.014,75082,POINT (-87.797373 41.944967),60634-20210201
60634,02/02/2021,297,5093,209,3986,0.053,88,1107,0.015,75082,POINT (-87.797373 41.944967),60634-20210202
60634,02/03/2021,276,5369,209,4195,0.056,67,1174,0.016,75082,POINT (-87.797373 41.944967),60634-20210203
60634,02/04/2021,241,5610,213,4408,0.059,28,1202,0.016,75082,POINT (-87.797373 41.944967),60634-20210204
60636,02/02/2021,42,858,34,746,0.025,8,112,0.004,30024,POINT (-87.668597 41.77599),60636-20210202
60636,02/03/2021,58,916,44,790,0.026,14,126,0.004,30024,POINT (-87.668597 41.77599),60636-20210203
60636,02/04/2021,56,972,50,840,0.028,6,132,0.004,30024,POINT (-87.668597 41.77599),60636-20210204
60637,01/21/2021,248,2523,204,1936,0.041,44,587,0.012,47300,POINT (-87.604053 41.780991),60637-20210121
60637,01/22/2021,189,2712,161,2097,0.044,28,615,0.013,47300,POINT (-87.604053 41.780991),60637-20210122
60637,01/23/2021,132,2844,90,2187,0.046,42,657,0.014,47300,POINT (-87.604053 41.780991),60637-20210123
60637,01/24/2021,47,2891,44,2231,0.047,3,660,0.014,47300,POINT (-87.604053 41.780991),60637-20210124
60637,01/25/2021,178,3069,133,2364,0.05,45,705,0.015,47300,POINT (-87.604053 41.780991),60637-20210125
60637,01/26/2021,146,3215,106,2470,0.052,40,745,0.016,47300,POINT (-87.604053 41.780991),60637-20210126
60637,01/27/2021,127,3342,97,2567,0.054,30,775,0.016,47300,POINT (-87.604053 41.780991),60637-20210127
60637,01/28/2021,142,3484,112,2679,0.057,30,805,0.017,47300,POINT (-87.604053 41.780991),60637-20210128
60637,01/29/2021,142,3626,129,2808,0.059,13,818,0.017,47300,POINT (-87.604053 41.780991),60637-20210129
60637,01/30/2021,67,3693,49,2857,0.06,18,836,0.018,47300,POINT (-87.604053 41.780991),60637-20210130
60637,01/31/2021,68,3761,67,2924,0.062,1,837,0.018,47300,POINT (-87.604053 41.780991),60637-20210131
60637,02/01/2021,75,3836,51,2975,0.063,24,861,0.018,47300,POINT (-87.604053 41.780991),60637-20210201
60637,02/02/2021,88,3924,70,3045,0.064,18,879,0.019,47300,POINT (-87.604053 41.780991),60637-20210202
60637,02/03/2021,186,4110,145,3190,0.067,41,920,0.019,47300,POINT (-87.604053 41.780991),60637-20210203
60637,02/04/2021,148,4258,78,3268,0.069,70,990,0.021,47300,POINT (-87.604053 41.780991),60637-20210204
60638,02/02/2021,253,3624,200,2902,0.049,53,722,0.012,58669,POINT (-87.771902 41.787032),60638-20210202
60638,02/03/2021,274,3898,229,3131,0.053,45,767,0.013,58669,POINT (-87.771902 41.787032),60638-20210203
60638,02/04/2021,230,4128,204,3335,0.057,26,793,0.014,58669,POINT (-87.771902 41.787032),60638-20210204
60639,01/18/2021,62,1422,48,1203,0.014,14,219,0.002,88204,POINT (-87.75531 41.920609),60639-20210118
60639,01/19/2021,53,1475,32,1235,0.014,21,240,0.003,88204,POINT (-87.75531 41.920609),60639-20210119
60639,01/20/2021,143,1618,100,1335,0.015,43,283,0.003,88204,POINT (-87.75531 41.920609),60639-20210120
60639,01/21/2021,166,1784,141,1476,0.017,25,308,0.003,88204,POINT (-87.75531 41.920609),60639-20210121
60639,01/22/2021,131,1915,124,1600,0.018,7,315,0.004,88204,POINT (-87.75531 41.920609),60639-20210122
60639,01/23/2021,54,1969,43,1643,0.019,11,326,0.004,88204,POINT (-87.75531 41.920609),60639-20210123
60639,01/24/2021,15,1984,13,1656,0.019,2,328,0.004,88204,POINT (-87.75531 41.920609),60639-20210124
60639,01/25/2021,105,2089,63,1719,0.019,42,370,0.004,88204,POINT (-87.75531 41.920609),60639-20210125
60639,01/26/2021,121,2210,81,1800,0.02,40,410,0.005,88204,POINT (-87.75531 41.920609),60639-20210126
60639,01/27/2021,177,2387,128,1928,0.022,49,459,0.005,88204,POINT (-87.75531 41.920609),60639-20210127
60639,01/28/2021,170,2557,135,2063,0.023,35,494,0.006,88204,POINT (-87.75531 41.920609),60639-20210128
60639,01/29/2021,180,2737,148,2211,0.025,32,526,0.006,88204,POINT (-87.75531 41.920609),60639-20210129
60639,01/30/2021,143,2880,130,2341,0.027,13,539,0.006,88204,POINT (-87.75531 41.920609),60639-20210130
60639,01/31/2021,39,2919,33,2374,0.027,6,545,0.006,88204,POINT (-87.75531 41.920609),60639-20210131
60639,02/01/2021,158,3077,131,2505,0.028,27,572,0.006,88204,POINT (-87.75531 41.920609),60639-20210201
60639,02/02/2021,199,3276,142,2647,0.03,57,629,0.007,88204,POINT (-87.75531 41.920609),60639-20210202
60639,02/03/2021,246,3522,196,2843,0.032,50,679,0.008,88204,POINT (-87.75531 41.920609),60639-20210203
60639,02/04/2021,205,3727,185,3028,0.034,20,699,0.008,88204,POINT (-87.75531 41.920609),60639-20210204
60640,01/18/2021,132,4113,67,3353,0.048,65,760,0.011,69363,POINT (-87.662232 41.971888),60640-20210118
60640,01/19/2021,153,4266,84,3437,0.05,69,829,0.012,69363,POINT (-87.662232 41.971888),60640-20210119
60640,01/20/2021,318,4584,239,3676,0.053,79,908,0.013,69363,POINT (-87.662232 41.971888),60640-20210120
60640,01/21/2021,477,5061,421,4097,0.059,56,964,0.014,69363,POINT (-87.662232 41.971888),60640-20210121
60640,01/22/2021,225,5286,199,4296,0.062,26,990,0.014,69363,POINT (-87.662232 41.971888),60640-20210122
60640,01/23/2021,128,5414,116,4412,0.064,12,1002,0.014,69363,POINT (-87.662232 41.971888),60640-20210123
60640,01/24/2021,65,5479,62,4474,0.065,3,1005,0.014,69363,POINT (-87.662232 41.971888),60640-20210124
60640,01/25/2021,204,5683,148,4622,0.067,56,1061,0.015,69363,POINT (-87.662232 41.971888),60640-20210125
60640,01/26/2021,310,5993,215,4837,0.07,95,1156,0.017,69363,POINT (-87.662232 41.971888),60640-20210126
60640,01/27/2021,638,6631,475,5312,0.077,163,1319,0.019,69363,POINT (-87.662232 41.971888),60640-20210127
60640,01/28/2021,469,7100,413,5725,0.083,56,1375,0.02,69363,POINT (-87.662232 41.971888),60640-20210128
60640,01/29/2021,515,7615,476,6201,0.089,39,1414,0.02,69363,POINT (-87.662232 41.971888),60640-20210129
60640,01/30/2021,147,7762,117,6318,0.091,30,1444,0.021,69363,POINT (-87.662232 41.971888),60640-20210130
60640,01/31/2021,133,7895,60,6378,0.092,73,1517,0.022,69363,POINT (-87.662232 41.971888),60640-20210131
60640,02/01/2021,234,8129,126,6504,0.094,108,1625,0.023,69363,POINT (-87.662232 41.971888),60640-20210201
60640,02/02/2021,283,8412,168,6672,0.096,115,1740,0.025,69363,POINT (-87.662232 41.971888),60640-20210202
60640,02/03/2021,505,8917,296,6968,0.1,209,1949,0.028,69363,POINT (-87.662232 41.971888),60640-20210203
60640,02/04/2021,276,9193,222,7190,0.104,54,2003,0.029,69363,POINT (-87.662232 41.971888),60640-20210204
60641,01/18/2021,72,2052,48,1594,0.023,24,458,0.007,69880,POINT (-87.746791 41.946682),60641-20210118
60641,01/19/2021,103,2155,62,1656,0.024,41,499,0.007,69880,POINT (-87.746791 41.946682),60641-20210119
60641,01/20/2021,171,2326,116,1772,0.025,55,554,0.008,69880,POINT (-87.746791 41.946682),60641-20210120
60641,01/21/2021,164,2490,132,1904,0.027,32,586,0.008,69880,POINT (-87.746791 41.946682),60641-20210121
60641,01/22/2021,190,2680,174,2078,0.03,16,602,0.009,69880,POINT (-87.746791 41.946682),60641-20210122
60641,01/23/2021,96,2776,89,2167,0.031,7,609,0.009,69880,POINT (-87.746791 41.946682),60641-20210123
60641,01/24/2021,33,2809,31,2198,0.031,2,611,0.009,69880,POINT (-87.746791 41.946682),60641-20210124
60641,01/25/2021,160,2969,124,2322,0.033,36,647,0.009,69880,POINT (-87.746791 41.946682),60641-20210125
60641,01/26/2021,170,3139,114,2436,0.035,56,703,0.01,69880,POINT (-87.746791 41.946682),60641-20210126
60641,01/27/2021,197,3336,153,2589,0.037,44,747,0.011,69880,POINT (-87.746791 41.946682),60641-20210127
60641,01/28/2021,231,3567,193,2782,0.04,38,785,0.011,69880,POINT (-87.746791 41.946682),60641-20210128
60641,01/29/2021,200,3767,176,2958,0.042,24,809,0.012,69880,POINT (-87.746791 41.946682),60641-20210129
60641,01/30/2021,157,3924,130,3088,0.044,27,836,0.012,69880,POINT (-87.746791 41.946682),60641-20210130
60641,01/31/2021,50,3974,40,3128,0.045,10,846,0.012,69880,POINT (-87.746791 41.946682),60641-20210131
60641,02/01/2021,232,4206,159,3287,0.047,73,919,0.013,69880,POINT (-87.746791 41.946682),60641-20210201
60641,02/02/2021,221,4427,146,3433,0.049,75,994,0.014,69880,POINT (-87.746791 41.946682),60641-20210202
60641,02/03/2021,263,4690,197,3630,0.052,66,1060,0.015,69880,POINT (-87.746791 41.946682),60641-20210203
60641,02/04/2021,207,4897,180,3810,0.055,27,1087,0.016,69880,POINT (-87.746791 41.946682),60641-20210204
60642,01/27/2021,85,2330,53,1557,0.079,32,773,0.039,19716,POINT (-87.657821 41.899935),60642-20210127
60642,01/28/2021,100,2430,77,1634,0.083,23,796,0.04,19716,POINT (-87.657821 41.899935),60642-20210128
60642,01/29/2021,102,2532,81,1715,0.087,21,817,0.041,19716,POINT (-87.657821 41.899935),60642-20210129
60642,01/30/2021,49,2581,28,1743,0.088,21,838,0.043,19716,POINT (-87.657821 41.899935),60642-20210130
60642,01/31/2021,12,2593,9,1752,0.089,3,841,0.043,19716,POINT (-87.657821 41.899935),60642-20210131
60642,02/01/2021,64,2657,50,1802,0.091,14,855,0.043,19716,POINT (-87.657821 41.899935),60642-20210201
60642,02/02/2021,99,2756,62,1864,0.095,37,892,0.045,19716,POINT (-87.657821 41.899935),60642-20210202
60642,02/03/2021,111,2867,78,1942,0.098,33,925,0.047,19716,POINT (-87.657821 41.899935),60642-20210203
60642,02/04/2021,98,2965,78,2020,0.102,20,945,0.048,19716,POINT (-87.657821 41.899935),60642-20210204
60643,01/18/2021,64,1662,52,1345,0.028,12,317,0.006,48887,POINT (-87.662381 41.700445),60643-20210118
60643,01/19/2021,126,1788,101,1446,0.03,25,342,0.007,48887,POINT (-87.662381 41.700445),60643-20210119
60643,01/20/2021,145,1933,110,1556,0.032,35,377,0.008,48887,POINT (-87.662381 41.700445),60643-20210120
60643,01/21/2021,175,2108,160,1716,0.035,15,392,0.008,48887,POINT (-87.662381 41.700445),60643-20210121
60643,01/22/2021,198,2306,184,1900,0.039,14,406,0.008,48887,POINT (-87.662381 41.700445),60643-20210122
60643,01/23/2021,107,2413,103,2003,0.041,4,410,0.008,48887,POINT (-87.662381 41.700445),60643-20210123
60643,01/24/2021,31,2444,31,2034,0.042,0,410,0.008,48887,POINT (-87.662381 41.700445),60643-20210124
60643,01/25/2021,116,2560,89,2123,0.043,27,437,0.009,48887,POINT (-87.662381 41.700445),60643-20210125
60643,01/26/2021,160,2720,128,2251,0.046,32,469,0.01,48887,POINT (-87.662381 41.700445),60643-20210126
60643,01/27/2021,220,2940,199,2450,0.05,21,490,0.01,48887,POINT (-87.662381 41.700445),60643-20210127
60643,01/28/2021,244,3184,214,2664,0.054,30,520,0.011,48887,POINT (-87.662381 41.700445),60643-20210128
60643,01/29/2021,216,3400,193,2857,0.058,23,543,0.011,48887,POINT (-87.662381 41.700445),60643-20210129
60643,01/30/2021,131,3531,114,2971,0.061,17,560,0.011,48887,POINT (-87.662381 41.700445),60643-20210130
60643,01/31/2021,39,3570,34,3005,0.061,5,565,0.012,48887,POINT (-87.662381 41.700445),60643-20210131
60643,02/01/2021,108,3678,91,3096,0.063,17,582,0.012,48887,POINT (-87.662381 41.700445),60643-20210201
60643,02/02/2021,220,3898,173,3269,0.067,47,629,0.013,48887,POINT (-87.662381 41.700445),60643-20210202
60643,02/03/2021,344,4242,229,3498,0.072,115,744,0.015,48887,POINT (-87.662381 41.700445),60643-20210203
60643,02/04/2021,243,4485,219,3717,0.076,24,768,0.016,48887,POINT (-87.662381 41.700445),60643-20210204
60644,01/26/2021,51,1416,39,1227,0.026,12,189,0.004,46591,POINT (-87.756863 41.881113),60644-20210126
60644,01/27/2021,79,1495,66,1293,0.028,13,202,0.004,46591,POINT (-87.756863 41.881113),60644-20210127
60644,01/28/2021,84,1579,73,1366,0.029,11,213,0.005,46591,POINT (-87.756863 41.881113),60644-20210128
60644,01/29/2021,97,1676,86,1452,0.031,11,224,0.005,46591,POINT (-87.756863 41.881113),60644-20210129
60644,01/30/2021,161,1837,90,1542,0.033,71,295,0.006,46591,POINT (-87.756863 41.881113),60644-20210130
60644,01/31/2021,9,1846,9,1551,0.033,0,295,0.006,46591,POINT (-87.756863 41.881113),60644-20210131
60644,02/01/2021,65,1911,49,1600,0.034,16,311,0.007,46591,POINT (-87.756863 41.881113),60644-20210201
60644,02/02/2021,388,2299,206,1806,0.039,182,493,0.011,46591,POINT (-87.756863 41.881113),60644-20210202
60644,02/03/2021,121,2420,105,1911,0.041,16,509,0.011,46591,POINT (-87.756863 41.881113),60644-20210203
60644,02/04/2021,116,2536,108,2019,0.043,8,517,0.011,46591,POINT (-87.756863 41.881113),60644-20210204
60645,01/18/2021,56,1869,42,1586,0.034,14,283,0.006,47270,POINT (-87.695049 42.008927),60645-20210118
60645,01/19/2021,79,1948,52,1638,0.035,27,310,0.007,47270,POINT (-87.695049 42.008927),60645-20210119
60645,01/20/2021,149,2097,104,1742,0.037,45,355,0.008,47270,POINT (-87.695049 42.008927),60645-20210120
60645,01/21/2021,147,2244,119,1861,0.039,28,383,0.008,47270,POINT (-87.695049 42.008927),60645-20210121
60645,01/22/2021,114,2358,105,1966,0.042,9,392,0.008,47270,POINT (-87.695049 42.008927),60645-20210122
60645,01/23/2021,64,2422,55,2021,0.043,9,401,0.008,47270,POINT (-87.695049 42.008927),60645-20210123
60645,01/24/2021,23,2445,21,2042,0.043,2,403,0.009,47270,POINT (-87.695049 42.008927),60645-20210124
60645,01/25/2021,218,2663,163,2205,0.047,55,458,0.01,47270,POINT (-87.695049 42.008927),60645-20210125
60645,01/26/2021,448,3111,335,2540,0.054,113,571,0.012,47270,POINT (-87.695049 42.008927),60645-20210126
60645,01/27/2021,273,3384,146,2686,0.057,127,698,0.015,47270,POINT (-87.695049 42.008927),60645-20210127
60645,01/28/2021,166,3550,141,2827,0.06,25,723,0.015,47270,POINT (-87.695049 42.008927),60645-20210128
60645,01/29/2021,164,3714,136,2963,0.063,28,751,0.016,47270,POINT (-87.695049 42.008927),60645-20210129
60645,01/30/2021,82,3796,67,3030,0.064,15,766,0.016,47270,POINT (-87.695049 42.008927),60645-20210130
60645,01/31/2021,46,3842,37,3067,0.065,9,775,0.016,47270,POINT (-87.695049 42.008927),60645-20210131
60645,02/01/2021,154,3996,90,3157,0.067,64,839,0.018,47270,POINT (-87.695049 42.008927),60645-20210201
60645,02/02/2021,199,4195,123,3280,0.069,76,915,0.019,47270,POINT (-87.695049 42.008927),60645-20210202
60645,02/03/2021,214,4409,167,3447,0.073,47,962,0.02,47270,POINT (-87.695049 42.008927),60645-20210203
60645,02/04/2021,258,4667,243,3690,0.078,15,977,0.021,47270,POINT (-87.695049 42.008927),60645-20210204
60646,01/26/2021,115,2242,83,1770,0.062,32,472,0.017,28569,POINT (-87.761826 41.993931),60646-20210126
60646,01/27/2021,131,2373,106,1876,0.066,25,497,0.017,28569,POINT (-87.761826 41.993931),60646-20210127
60646,01/28/2021,165,2538,145,2021,0.071,20,517,0.018,28569,POINT (-87.761826 41.993931),60646-20210128
60646,01/29/2021,114,2652,100,2121,0.074,14,531,0.019,28569,POINT (-87.761826 41.993931),60646-20210129
60646,01/30/2021,77,2729,69,2190,0.077,8,539,0.019,28569,POINT (-87.761826 41.993931),60646-20210130
60646,01/31/2021,24,2753,21,2211,0.077,3,542,0.019,28569,POINT (-87.761826 41.993931),60646-20210131
60646,02/01/2021,109,2862,79,2290,0.08,30,572,0.02,28569,POINT (-87.761826 41.993931),60646-20210201
60646,02/02/2021,165,3027,112,2402,0.084,53,625,0.022,28569,POINT (-87.761826 41.993931),60646-20210202
60646,02/03/2021,177,3204,136,2538,0.089,41,666,0.023,28569,POINT (-87.761826 41.993931),60646-20210203
60646,02/04/2021,162,3366,143,2681,0.094,19,685,0.024,28569,POINT (-87.761826 41.993931),60646-20210204
60647,01/18/2021,134,3958,91,2978,0.034,43,980,0.011,87633,POINT (-87.701101 41.921058),60647-20210118
60647,01/19/2021,180,4138,97,3075,0.035,83,1063,0.012,87633,POINT (-87.701101 41.921058),60647-20210119
60647,01/20/2021,257,4395,165,3240,0.037,92,1155,0.013,87633,POINT (-87.701101 41.921058),60647-20210120
60647,01/21/2021,367,4762,311,3551,0.041,56,1211,0.014,87633,POINT (-87.701101 41.921058),60647-20210121
60647,01/22/2021,286,5048,269,3820,0.044,17,1228,0.014,87633,POINT (-87.701101 41.921058),60647-20210122
60647,01/23/2021,128,5176,115,3935,0.045,13,1241,0.014,87633,POINT (-87.701101 41.921058),60647-20210123
60647,01/24/2021,57,5233,54,3989,0.046,3,1244,0.014,87633,POINT (-87.701101 41.921058),60647-20210124
60647,01/25/2021,173,5406,128,4117,0.047,45,1289,0.015,87633,POINT (-87.701101 41.921058),60647-20210125
60647,01/26/2021,243,5649,162,4279,0.049,81,1370,0.016,87633,POINT (-87.701101 41.921058),60647-20210126
60647,01/27/2021,287,5936,228,4507,0.051,59,1429,0.016,87633,POINT (-87.701101 41.921058),60647-20210127
60647,01/28/2021,356,6292,291,4798,0.055,65,1494,0.017,87633,POINT (-87.701101 41.921058),60647-20210128
60647,01/29/2021,315,6607,273,5071,0.058,42,1536,0.018,87633,POINT (-87.701101 41.921058),60647-20210129
60647,01/30/2021,181,6788,137,5208,0.059,44,1580,0.018,87633,POINT (-87.701101 41.921058),60647-20210130
60647,01/31/2021,70,6858,55,5263,0.06,15,1595,0.018,87633,POINT (-87.701101 41.921058),60647-20210131
60647,02/01/2021,208,7066,160,5423,0.062,48,1643,0.019,87633,POINT (-87.701101 41.921058),60647-20210201
60647,02/02/2021,330,7396,221,5644,0.064,109,1752,0.02,87633,POINT (-87.701101 41.921058),60647-20210202
60647,02/03/2021,363,7759,293,5937,0.068,70,1822,0.021,87633,POINT (-87.701101 41.921058),60647-20210203
60647,02/04/2021,303,8062,235,6172,0.07,68,1890,0.022,87633,POINT (-87.701101 41.921058),60647-20210204
60649,01/16/2021,13,1003,13,896,0.019,0,107,0.002,46633,POINT (-87.571522 41.762202),60649-20210116
60649,01/17/2021,5,1008,4,900,0.019,1,108,0.002,46633,POINT (-87.571522 41.762202),60649-20210117
60649,01/18/2021,55,1063,46,946,0.02,9,117,0.003,46633,POINT (-87.571522 41.762202),60649-20210118
60649,01/19/2021,187,1250,171,1117,0.024,16,133,0.003,46633,POINT (-87.571522 41.762202),60649-20210119
60649,01/20/2021,102,1352,84,1201,0.026,18,151,0.003,46633,POINT (-87.571522 41.762202),60649-20210120
60649,01/21/2021,145,1497,127,1328,0.028,18,169,0.004,46633,POINT (-87.571522 41.762202),60649-20210121
60649,01/22/2021,159,1656,150,1478,0.032,9,178,0.004,46633,POINT (-87.571522 41.762202),60649-20210122
60649,01/23/2021,59,1715,52,1530,0.033,7,185,0.004,46633,POINT (-87.571522 41.762202),60649-20210123
60649,01/24/2021,35,1750,34,1564,0.034,1,186,0.004,46633,POINT (-87.571522 41.762202),60649-20210124
60649,01/25/2021,98,1848,87,1651,0.035,11,197,0.004,46633,POINT (-87.571522 41.762202),60649-20210125
60649,01/26/2021,205,2053,122,1773,0.038,83,280,0.006,46633,POINT (-87.571522 41.762202),60649-20210126
60649,01/27/2021,116,2169,97,1870,0.04,19,299,0.006,46633,POINT (-87.571522 41.762202),60649-20210127
60649,01/28/2021,130,2299,117,1987,0.043,13,312,0.007,46633,POINT (-87.571522 41.762202),60649-20210128
60649,01/29/2021,161,2460,141,2128,0.046,20,332,0.007,46633,POINT (-87.571522 41.762202),60649-20210129
60649,01/30/2021,57,2517,52,2180,0.047,5,337,0.007,46633,POINT (-87.571522 41.762202),60649-20210130
60649,01/31/2021,11,2528,11,2191,0.047,0,337,0.007,46633,POINT (-87.571522 41.762202),60649-20210131
60649,02/01/2021,92,2620,78,2269,0.049,14,351,0.008,46633,POINT (-87.571522 41.762202),60649-20210201
60649,02/02/2021,91,2711,63,2332,0.05,28,379,0.008,46633,POINT (-87.571522 41.762202),60649-20210202
60649,02/03/2021,130,2841,103,2435,0.052,27,406,0.009,46633,POINT (-87.571522 41.762202),60649-20210203
60649,02/04/2021,150,2991,126,2561,0.055,24,430,0.009,46633,POINT (-87.571522 41.762202),60649-20210204
60651,01/26/2021,90,1379,68,1142,0.018,22,237,0.004,63492,POINT (-87.741017 41.901964),60651-20210126
60651,01/27/2021,121,1500,108,1250,0.02,13,250,0.004,63492,POINT (-87.741017 41.901964),60651-20210127
60651,01/28/2021,142,1642,118,1368,0.022,24,274,0.004,63492,POINT (-87.741017 41.901964),60651-20210128
60651,01/29/2021,175,1817,159,1527,0.024,16,290,0.005,63492,POINT (-87.741017 41.901964),60651-20210129
60651,01/30/2021,65,1882,53,1580,0.025,12,302,0.005,63492,POINT (-87.741017 41.901964),60651-20210130
60651,01/31/2021,12,1894,11,1591,0.025,1,303,0.005,63492,POINT (-87.741017 41.901964),60651-20210131
60651,02/01/2021,91,1985,76,1667,0.026,15,318,0.005,63492,POINT (-87.741017 41.901964),60651-20210201
60651,02/02/2021,318,2303,257,1924,0.03,61,379,0.006,63492,POINT (-87.741017 41.901964),60651-20210202
60651,02/03/2021,157,2460,133,2057,0.032,24,403,0.006,63492,POINT (-87.741017 41.901964),60651-20210203
60651,02/04/2021,140,2600,129,2186,0.034,11,414,0.007,63492,POINT (-87.741017 41.901964),60651-20210204
60652,01/18/2021,28,914,20,760,0.017,8,154,0.004,43447,POINT (-87.714238 41.745398),60652-20210118
60652,01/19/2021,51,965,23,783,0.018,28,182,0.004,43447,POINT (-87.714238 41.745398),60652-20210119
60652,01/20/2021,74,1039,44,827,0.019,30,212,0.005,43447,POINT (-87.714238 41.745398),60652-20210120
60652,01/21/2021,81,1120,63,890,0.02,18,230,0.005,43447,POINT (-87.714238 41.745398),60652-20210121
60652,01/22/2021,74,1194,66,956,0.022,8,238,0.005,43447,POINT (-87.714238 41.745398),60652-20210122
60652,01/23/2021,38,1232,36,992,0.023,2,240,0.006,43447,POINT (-87.714238 41.745398),60652-20210123
60652,01/24/2021,12,1244,12,1004,0.023,0,240,0.006,43447,POINT (-87.714238 41.745398),60652-20210124
60652,01/25/2021,172,1416,68,1072,0.025,104,344,0.008,43447,POINT (-87.714238 41.745398),60652-20210125
60652,01/26/2021,94,1510,68,1140,0.026,26,370,0.009,43447,POINT (-87.714238 41.745398),60652-20210126
60652,01/27/2021,128,1638,109,1249,0.029,19,389,0.009,43447,POINT (-87.714238 41.745398),60652-20210127
60652,01/28/2021,130,1768,103,1352,0.031,27,416,0.01,43447,POINT (-87.714238 41.745398),60652-20210128
60652,01/29/2021,126,1894,102,1454,0.033,24,440,0.01,43447,POINT (-87.714238 41.745398),60652-20210129
60652,01/30/2021,75,1969,63,1517,0.035,12,452,0.01,43447,POINT (-87.714238 41.745398),60652-20210130
60652,01/31/2021,10,1979,6,1523,0.035,4,456,0.01,43447,POINT (-87.714238 41.745398),60652-20210131
60652,02/01/2021,90,2069,75,1598,0.037,15,471,0.011,43447,POINT (-87.714238 41.745398),60652-20210201
60652,02/02/2021,116,2185,86,1684,0.039,30,501,0.012,43447,POINT (-87.714238 41.745398),60652-20210202
60652,02/03/2021,190,2375,151,1835,0.042,39,540,0.012,43447,POINT (-87.714238 41.745398),60652-20210203
60652,02/04/2021,139,2514,112,1947,0.045,27,567,0.013,43447,POINT (-87.714238 41.745398),60652-20210204
60653,01/16/2021,12,949,10,785,0.024,2,164,0.005,33154,POINT (-87.611244 41.819261),60653-20210116
60653,01/17/2021,6,955,2,787,0.024,4,168,0.005,33154,POINT (-87.611244 41.819261),60653-20210117
60653,01/18/2021,38,993,24,811,0.024,14,182,0.005,33154,POINT (-87.611244 41.819261),60653-20210118
60653,01/19/2021,89,1082,67,878,0.026,22,204,0.006,33154,POINT (-87.611244 41.819261),60653-20210119
60653,01/20/2021,63,1145,39,917,0.028,24,228,0.007,33154,POINT (-87.611244 41.819261),60653-20210120
60653,01/21/2021,86,1231,73,990,0.03,13,241,0.007,33154,POINT (-87.611244 41.819261),60653-20210121
60653,01/22/2021,108,1339,101,1091,0.033,7,248,0.007,33154,POINT (-87.611244 41.819261),60653-20210122
60653,01/23/2021,62,1401,60,1151,0.035,2,250,0.008,33154,POINT (-87.611244 41.819261),60653-20210123
60653,01/24/2021,17,1418,17,1168,0.035,0,250,0.008,33154,POINT (-87.611244 41.819261),60653-20210124
60653,01/25/2021,80,1498,65,1233,0.037,15,265,0.008,33154,POINT (-87.611244 41.819261),60653-20210125
60653,01/26/2021,97,1595,75,1308,0.039,22,287,0.009,33154,POINT (-87.611244 41.819261),60653-20210126
60653,01/27/2021,209,1804,116,1424,0.043,93,380,0.011,33154,POINT (-87.611244 41.819261),60653-20210127
60653,01/28/2021,114,1918,102,1526,0.046,12,392,0.012,33154,POINT (-87.611244 41.819261),60653-20210128
60653,01/29/2021,178,2096,165,1691,0.051,13,405,0.012,33154,POINT (-87.611244 41.819261),60653-20210129
60653,01/30/2021,49,2145,41,1732,0.052,8,413,0.012,33154,POINT (-87.611244 41.819261),60653-20210130
60653,01/31/2021,8,2153,7,1739,0.052,1,414,0.012,33154,POINT (-87.611244 41.819261),60653-20210131
60653,02/01/2021,59,2212,47,1786,0.054,12,426,0.013,33154,POINT (-87.611244 41.819261),60653-20210201
60653,02/02/2021,104,2316,72,1858,0.056,32,458,0.014,33154,POINT (-87.611244 41.819261),60653-20210202
60653,02/03/2021,103,2419,88,1946,0.059,15,473,0.014,33154,POINT (-87.611244 41.819261),60653-20210203
60653,02/04/2021,143,2562,130,2076,0.063,13,486,0.015,33154,POINT (-87.611244 41.819261),60653-20210204
60654,12/23/2020,36,518,36,518,0.026,0,0,0,20022,POINT (-87.636354 41.892485),60654-20201223
60654,12/24/2020,10,528,10,528,0.026,0,0,0,20022,POINT (-87.636354 41.892485),60654-20201224
60654,12/25/2020,0,528,0,528,0.026,0,0,0,20022,POINT (-87.636354 41.892485),60654-20201225
60654,12/26/2020,17,545,17,545,0.027,0,0,0,20022,POINT (-87.636354 41.892485),60654-20201226
60654,12/27/2020,0,545,0,545,0.027,0,0,0,20022,POINT (-87.636354 41.892485),60654-20201227
60654,12/28/2020,27,572,27,572,0.029,0,0,0,20022,POINT (-87.636354 41.892485),60654-20201228
60654,12/29/2020,48,620,48,620,0.031,0,0,0,20022,POINT (-87.636354 41.892485),60654-20201229
60654,12/30/2020,33,653,33,653,0.033,0,0,0,20022,POINT (-87.636354 41.892485),60654-20201230
60654,12/31/2020,12,665,12,665,0.033,0,0,0,20022,POINT (-87.636354 41.892485),60654-20201231
60654,01/01/2021,1,666,1,666,0.033,0,0,0,20022,POINT (-87.636354 41.892485),60654-20210101
60654,01/02/2021,14,680,14,680,0.034,0,0,0,20022,POINT (-87.636354 41.892485),60654-20210102
60654,01/03/2021,9,689,9,689,0.034,0,0,0,20022,POINT (-87.636354 41.892485),60654-20210103
60654,01/04/2021,27,716,24,713,0.036,3,3,0,20022,POINT (-87.636354 41.892485),60654-20210104
60654,01/05/2021,47,763,40,753,0.038,7,10,0,20022,POINT (-87.636354 41.892485),60654-20210105
60654,01/06/2021,38,801,21,774,0.039,17,27,0.001,20022,POINT (-87.636354 41.892485),60654-20210106
60654,01/07/2021,108,909,28,802,0.04,80,107,0.005,20022,POINT (-87.636354 41.892485),60654-20210107
60654,01/08/2021,149,1058,33,835,0.042,116,223,0.011,20022,POINT (-87.636354 41.892485),60654-20210108
60654,01/09/2021,79,1137,13,848,0.042,66,289,0.014,20022,POINT (-87.636354 41.892485),60654-20210109
60654,01/10/2021,19,1156,5,853,0.043,14,303,0.015,20022,POINT (-87.636354 41.892485),60654-20210110
60654,01/11/2021,104,1260,18,871,0.044,86,389,0.019,20022,POINT (-87.636354 41.892485),60654-20210111
60654,01/12/2021,117,1377,39,910,0.045,78,467,0.023,20022,POINT (-87.636354 41.892485),60654-20210112
60654,01/13/2021,69,1446,32,942,0.047,37,504,0.025,20022,POINT (-87.636354 41.892485),60654-20210113
60654,01/14/2021,32,1478,23,965,0.048,9,513,0.026,20022,POINT (-87.636354 41.892485),60654-20210114
60654,01/15/2021,41,1519,33,998,0.05,8,521,0.026,20022,POINT (-87.636354 41.892485),60654-20210115
60654,01/16/2021,33,1552,24,1022,0.051,9,530,0.026,20022,POINT (-87.636354 41.892485),60654-20210116
60654,01/17/2021,19,1571,8,1030,0.051,11,541,0.027,20022,POINT (-87.636354 41.892485),60654-20210117
60654,01/18/2021,46,1617,25,1055,0.053,21,562,0.028,20022,POINT (-87.636354 41.892485),60654-20210118
60654,01/19/2021,68,1685,28,1083,0.054,40,602,0.03,20022,POINT (-87.636354 41.892485),60654-20210119
60654,01/20/2021,61,1746,41,1124,0.056,20,622,0.031,20022,POINT (-87.636354 41.892485),60654-20210120
60654,01/21/2021,91,1837,75,1199,0.06,16,638,0.032,20022,POINT (-87.636354 41.892485),60654-20210121
60654,01/22/2021,96,1933,80,1279,0.064,16,654,0.033,20022,POINT (-87.636354 41.892485),60654-20210122
60654,01/23/2021,48,1981,43,1322,0.066,5,659,0.033,20022,POINT (-87.636354 41.892485),60654-20210123
60654,01/24/2021,21,2002,20,1342,0.067,1,660,0.033,20022,POINT (-87.636354 41.892485),60654-20210124
60654,01/25/2021,77,2079,63,1405,0.07,14,674,0.034,20022,POINT (-87.636354 41.892485),60654-20210125
60654,01/26/2021,83,2162,41,1446,0.072,42,716,0.036,20022,POINT (-87.636354 41.892485),60654-20210126
60654,01/27/2021,69,2231,53,1499,0.075,16,732,0.037,20022,POINT (-87.636354 41.892485),60654-20210127
60654,01/28/2021,111,2342,75,1574,0.079,36,768,0.038,20022,POINT (-87.636354 41.892485),60654-20210128
60654,01/29/2021,81,2423,70,1644,0.082,11,779,0.039,20022,POINT (-87.636354 41.892485),60654-20210129
60654,01/30/2021,50,2473,38,1682,0.084,12,791,0.04,20022,POINT (-87.636354 41.892485),60654-20210130
60654,01/31/2021,30,2503,26,1708,0.085,4,795,0.04,20022,POINT (-87.636354 41.892485),60654-20210131
60654,02/01/2021,48,2551,37,1745,0.087,11,806,0.04,20022,POINT (-87.636354 41.892485),60654-20210201
60654,02/02/2021,106,2657,66,1811,0.09,40,846,0.042,20022,POINT (-87.636354 41.892485),60654-20210202
60654,02/03/2021,76,2733,52,1863,0.093,24,870,0.043,20022,POINT (-87.636354 41.892485),60654-20210203
60654,02/04/2021,76,2809,61,1924,0.096,15,885,0.044,20022,POINT (-87.636354 41.892485),60654-20210204
60655,01/18/2021,42,1506,39,1137,0.04,3,369,0.013,28569,POINT (-87.701434 41.696456),60655-20210118
60655,01/19/2021,57,1563,47,1184,0.041,10,379,0.013,28569,POINT (-87.701434 41.696456),60655-20210119
60655,01/20/2021,82,1645,60,1244,0.044,22,401,0.014,28569,POINT (-87.701434 41.696456),60655-20210120
60655,01/21/2021,111,1756,98,1342,0.047,13,414,0.014,28569,POINT (-87.701434 41.696456),60655-20210121
60655,01/22/2021,150,1906,142,1484,0.052,8,422,0.015,28569,POINT (-87.701434 41.696456),60655-20210122
60655,01/23/2021,82,1988,73,1557,0.054,9,431,0.015,28569,POINT (-87.701434 41.696456),60655-20210123
60655,01/24/2021,30,2018,29,1586,0.056,1,432,0.015,28569,POINT (-87.701434 41.696456),60655-20210124
60655,01/25/2021,117,2135,91,1677,0.059,26,458,0.016,28569,POINT (-87.701434 41.696456),60655-20210125
60655,01/26/2021,132,2267,100,1777,0.062,32,490,0.017,28569,POINT (-87.701434 41.696456),60655-20210126
60655,01/27/2021,223,2490,198,1975,0.069,25,515,0.018,28569,POINT (-87.701434 41.696456),60655-20210127
60655,01/28/2021,228,2718,191,2166,0.076,37,552,0.019,28569,POINT (-87.701434 41.696456),60655-20210128
60655,01/29/2021,169,2887,140,2306,0.081,29,581,0.02,28569,POINT (-87.701434 41.696456),60655-20210129
60655,01/30/2021,235,3122,122,2428,0.085,113,694,0.024,28569,POINT (-87.701434 41.696456),60655-20210130
60655,01/31/2021,22,3144,21,2449,0.086,1,695,0.024,28569,POINT (-87.701434 41.696456),60655-20210131
60655,02/01/2021,118,3262,81,2530,0.089,37,732,0.026,28569,POINT (-87.701434 41.696456),60655-20210201
60655,02/02/2021,213,3475,148,2678,0.094,65,797,0.028,28569,POINT (-87.701434 41.696456),60655-20210202
60655,02/03/2021,183,3658,158,2836,0.099,25,822,0.029,28569,POINT (-87.701434 41.696456),60655-20210203
60655,02/04/2021,187,3845,168,3004,0.105,19,841,0.029,28569,POINT (-87.701434 41.696456),60655-20210204
60656,01/18/2021,20,782,17,575,0.02,3,207,0.007,28218,POINT (-87.817934 41.974566),60656-20210118
60656,01/19/2021,44,826,33,608,0.022,11,218,0.008,28218,POINT (-87.817934 41.974566),60656-20210119
60656,01/20/2021,64,890,51,659,0.023,13,231,0.008,28218,POINT (-87.817934 41.974566),60656-20210120
60656,01/21/2021,63,953,51,710,0.025,12,243,0.009,28218,POINT (-87.817934 41.974566),60656-20210121
60656,01/22/2021,53,1006,51,761,0.027,2,245,0.009,28218,POINT (-87.817934 41.974566),60656-20210122
60656,01/23/2021,34,1040,29,790,0.028,5,250,0.009,28218,POINT (-87.817934 41.974566),60656-20210123
60656,01/24/2021,17,1057,14,804,0.028,3,253,0.009,28218,POINT (-87.817934 41.974566),60656-20210124
60656,01/25/2021,54,1111,41,845,0.03,13,266,0.009,28218,POINT (-87.817934 41.974566),60656-20210125
60656,01/26/2021,50,1161,33,878,0.031,17,283,0.01,28218,POINT (-87.817934 41.974566),60656-20210126
60656,01/27/2021,100,1261,81,959,0.034,19,302,0.011,28218,POINT (-87.817934 41.974566),60656-20210127
60656,01/28/2021,91,1352,76,1035,0.037,15,317,0.011,28218,POINT (-87.817934 41.974566),60656-20210128
60656,01/29/2021,88,1440,77,1112,0.039,11,328,0.012,28218,POINT (-87.817934 41.974566),60656-20210129
60656,01/30/2021,66,1506,53,1165,0.041,13,341,0.012,28218,POINT (-87.817934 41.974566),60656-20210130
60656,01/31/2021,14,1520,13,1178,0.042,1,342,0.012,28218,POINT (-87.817934 41.974566),60656-20210131
60656,02/01/2021,69,1589,52,1230,0.044,17,359,0.013,28218,POINT (-87.817934 41.974566),60656-20210201
60656,02/02/2021,77,1666,57,1287,0.046,20,379,0.013,28218,POINT (-87.817934 41.974566),60656-20210202
60656,02/03/2021,108,1774,84,1371,0.049,24,403,0.014,28218,POINT (-87.817934 41.974566),60656-20210203
60656,02/04/2021,96,1870,86,1457,0.052,10,413,0.015,28218,POINT (-87.817934 41.974566),60656-20210204
60657,01/16/2021,155,5182,134,3753,0.053,21,1429,0.02,70958,POINT (-87.658216 41.939715),60657-20210116
60657,01/17/2021,287,5469,254,4007,0.056,33,1462,0.021,70958,POINT (-87.658216 41.939715),60657-20210117
60657,01/18/2021,290,5759,175,4182,0.059,115,1577,0.022,70958,POINT (-87.658216 41.939715),60657-20210118
60657,01/19/2021,226,5985,97,4279,0.06,129,1706,0.024,70958,POINT (-87.658216 41.939715),60657-20210119
60657,01/20/2021,326,6311,172,4451,0.063,154,1860,0.026,70958,POINT (-87.658216 41.939715),60657-20210120
60657,01/21/2021,357,6668,284,4735,0.067,73,1933,0.027,70958,POINT (-87.658216 41.939715),60657-20210121
60657,01/22/2021,340,7008,296,5031,0.071,44,1977,0.028,70958,POINT (-87.658216 41.939715),60657-20210122
60657,01/23/2021,173,7181,150,5181,0.073,23,2000,0.028,70958,POINT (-87.658216 41.939715),60657-20210123
60657,01/24/2021,68,7249,58,5239,0.074,10,2010,0.028,70958,POINT (-87.658216 41.939715),60657-20210124
60657,01/25/2021,260,7509,191,5430,0.077,69,2079,0.029,70958,POINT (-87.658216 41.939715),60657-20210125
60657,01/26/2021,341,7850,188,5618,0.079,153,2232,0.031,70958,POINT (-87.658216 41.939715),60657-20210126
60657,01/27/2021,296,8146,201,5819,0.082,95,2327,0.033,70958,POINT (-87.658216 41.939715),60657-20210127
60657,01/28/2021,381,8527,300,6119,0.086,81,2408,0.034,70958,POINT (-87.658216 41.939715),60657-20210128
60657,01/29/2021,370,8897,329,6448,0.091,41,2449,0.035,70958,POINT (-87.658216 41.939715),60657-20210129
60657,01/30/2021,164,9061,114,6562,0.092,50,2499,0.035,70958,POINT (-87.658216 41.939715),60657-20210130
60657,01/31/2021,70,9131,57,6619,0.093,13,2512,0.035,70958,POINT (-87.658216 41.939715),60657-20210131
60657,02/01/2021,254,9385,147,6766,0.095,107,2619,0.037,70958,POINT (-87.658216 41.939715),60657-20210201
60657,02/02/2021,369,9754,219,6985,0.098,150,2769,0.039,70958,POINT (-87.658216 41.939715),60657-20210202
60657,02/03/2021,339,10093,248,7233,0.102,91,2860,0.04,70958,POINT (-87.658216 41.939715),60657-20210203
60657,02/04/2021,318,10411,259,7492,0.106,59,2919,0.041,70958,POINT (-87.658216 41.939715),60657-20210204
60659,01/16/2021,110,1455,108,1222,0.029,2,233,0.005,42735,POINT (-87.703266 41.990803),60659-20210116
60659,01/17/2021,6,1461,6,1228,0.029,0,233,0.005,42735,POINT (-87.703266 41.990803),60659-20210117
60659,01/18/2021,50,1511,34,1262,0.03,16,249,0.006,42735,POINT (-87.703266 41.990803),60659-20210118
60659,01/19/2021,85,1596,49,1311,0.031,36,285,0.007,42735,POINT (-87.703266 41.990803),60659-20210119
60659,01/20/2021,96,1692,65,1376,0.032,31,316,0.007,42735,POINT (-87.703266 41.990803),60659-20210120
60659,01/21/2021,123,1815,97,1473,0.034,26,342,0.008,42735,POINT (-87.703266 41.990803),60659-20210121
60659,01/22/2021,102,1917,95,1568,0.037,7,349,0.008,42735,POINT (-87.703266 41.990803),60659-20210122
60659,01/23/2021,49,1966,43,1611,0.038,6,355,0.008,42735,POINT (-87.703266 41.990803),60659-20210123
60659,01/24/2021,19,1985,14,1625,0.038,5,360,0.008,42735,POINT (-87.703266 41.990803),60659-20210124
60659,01/25/2021,89,2074,56,1681,0.039,33,393,0.009,42735,POINT (-87.703266 41.990803),60659-20210125
60659,01/26/2021,113,2187,68,1749,0.041,45,438,0.01,42735,POINT (-87.703266 41.990803),60659-20210126
60659,01/27/2021,164,2351,103,1852,0.043,61,499,0.012,42735,POINT (-87.703266 41.990803),60659-20210127
60659,01/28/2021,114,2465,97,1949,0.046,17,516,0.012,42735,POINT (-87.703266 41.990803),60659-20210128
60659,01/29/2021,113,2578,97,2046,0.048,16,532,0.012,42735,POINT (-87.703266 41.990803),60659-20210129
60659,01/30/2021,90,2668,82,2128,0.05,8,540,0.013,42735,POINT (-87.703266 41.990803),60659-20210130
60659,01/31/2021,41,2709,24,2152,0.05,17,557,0.013,42735,POINT (-87.703266 41.990803),60659-20210131
60659,02/01/2021,102,2811,69,2221,0.052,33,590,0.014,42735,POINT (-87.703266 41.990803),60659-20210201
60659,02/02/2021,119,2930,83,2304,0.054,36,626,0.015,42735,POINT (-87.703266 41.990803),60659-20210202
60659,02/03/2021,133,3063,99,2403,0.056,34,660,0.015,42735,POINT (-87.703266 41.990803),60659-20210203
60659,02/04/2021,193,3256,175,2578,0.06,18,678,0.016,42735,POINT (-87.703266 41.990803),60659-20210204
60660,01/18/2021,61,2382,33,2012,0.045,28,370,0.008,44498,POINT (-87.666362 41.991062),60660-20210118
60660,01/19/2021,90,2472,49,2061,0.046,41,411,0.009,44498,POINT (-87.666362 41.991062),60660-20210119
60660,01/20/2021,110,2582,83,2144,0.048,27,438,0.01,44498,POINT (-87.666362 41.991062),60660-20210120
60660,01/21/2021,185,2767,153,2297,0.052,32,470,0.011,44498,POINT (-87.666362 41.991062),60660-20210121
60660,01/22/2021,146,2913,123,2420,0.054,23,493,0.011,44498,POINT (-87.666362 41.991062),60660-20210122
60660,01/23/2021,84,2997,72,2492,0.056,12,505,0.011,44498,POINT (-87.666362 41.991062),60660-20210123
60660,01/24/2021,20,3017,19,2511,0.056,1,506,0.011,44498,POINT (-87.666362 41.991062),60660-20210124
60660,01/25/2021,143,3160,101,2612,0.059,42,548,0.012,44498,POINT (-87.666362 41.991062),60660-20210125
60660,01/26/2021,145,3305,95,2707,0.061,50,598,0.013,44498,POINT (-87.666362 41.991062),60660-20210126
60660,01/27/2021,244,3549,156,2863,0.064,88,686,0.015,44498,POINT (-87.666362 41.991062),60660-20210127
60660,01/28/2021,198,3747,156,3019,0.068,42,728,0.016,44498,POINT (-87.666362 41.991062),60660-20210128
60660,01/29/2021,182,3929,163,3182,0.072,19,747,0.017,44498,POINT (-87.666362 41.991062),60660-20210129
60660,01/30/2021,91,4020,81,3263,0.073,10,757,0.017,44498,POINT (-87.666362 41.991062),60660-20210130
60660,01/31/2021,53,4073,31,3294,0.074,22,779,0.018,44498,POINT (-87.666362 41.991062),60660-20210131
60660,02/01/2021,132,4205,100,3394,0.076,32,811,0.018,44498,POINT (-87.666362 41.991062),60660-20210201
60660,02/02/2021,166,4371,109,3503,0.079,57,868,0.02,44498,POINT (-87.666362 41.991062),60660-20210202
60660,02/03/2021,239,4610,127,3630,0.082,112,980,0.022,44498,POINT (-87.666362 41.991062),60660-20210203
60660,02/04/2021,201,4811,155,3785,0.085,46,1026,0.023,44498,POINT (-87.666362 41.991062),60660-20210204
60661,01/18/2021,24,1085,13,733,0.071,11,352,0.034,10354,POINT (-87.644283 41.882786),60661-20210118
60661,01/19/2021,34,1119,10,743,0.072,24,376,0.036,10354,POINT (-87.644283 41.882786),60661-20210119
60661,01/20/2021,46,1165,17,760,0.073,29,405,0.039,10354,POINT (-87.644283 41.882786),60661-20210120
60661,01/21/2021,55,1220,34,794,0.077,21,426,0.041,10354,POINT (-87.644283 41.882786),60661-20210121
60661,01/22/2021,34,1254,32,826,0.08,2,428,0.041,10354,POINT (-87.644283 41.882786),60661-20210122
60661,01/23/2021,19,1273,15,841,0.081,4,432,0.042,10354,POINT (-87.644283 41.882786),60661-20210123
60661,01/24/2021,8,1281,3,844,0.082,5,437,0.042,10354,POINT (-87.644283 41.882786),60661-20210124
60661,01/25/2021,35,1316,8,852,0.082,27,464,0.045,10354,POINT (-87.644283 41.882786),60661-20210125
60661,01/26/2021,43,1359,26,878,0.085,17,481,0.046,10354,POINT (-87.644283 41.882786),60661-20210126
60661,01/27/2021,43,1402,29,907,0.088,14,495,0.048,10354,POINT (-87.644283 41.882786),60661-20210127
60661,01/28/2021,65,1467,48,955,0.092,17,512,0.049,10354,POINT (-87.644283 41.882786),60661-20210128
60661,01/29/2021,40,1507,31,986,0.095,9,521,0.05,10354,POINT (-87.644283 41.882786),60661-20210129
60661,01/30/2021,15,1522,6,992,0.096,9,530,0.051,10354,POINT (-87.644283 41.882786),60661-20210130
60661,01/31/2021,5,1527,3,995,0.096,2,532,0.051,10354,POINT (-87.644283 41.882786),60661-20210131
60661,02/01/2021,32,1559,22,1017,0.098,10,542,0.052,10354,POINT (-87.644283 41.882786),60661-20210201
60661,02/02/2021,46,1605,23,1040,0.1,23,565,0.055,10354,POINT (-87.644283 41.882786),60661-20210202
60661,02/03/2021,41,1646,27,1067,0.103,14,579,0.056,10354,POINT (-87.644283 41.882786),60661-20210203
60661,02/04/2021,53,1699,38,1105,0.107,15,594,0.057,10354,POINT (-87.644283 41.882786),60661-20210204
60707,01/27/2021,45,672,35,545,0.013,10,127,0.003,43093,POINT (-87.808283 41.921777),60707-20210127
60707,01/28/2021,51,723,45,590,0.014,6,133,0.003,43093,POINT (-87.808283 41.921777),60707-20210128
60707,01/29/2021,48,771,43,633,0.015,5,138,0.003,43093,POINT (-87.808283 41.921777),60707-20210129
60707,01/30/2021,38,809,34,667,0.015,4,142,0.003,43093,POINT (-87.808283 41.921777),60707-20210130
60707,01/31/2021,8,817,7,674,0.016,1,143,0.003,43093,POINT (-87.808283 41.921777),60707-20210131
60707,02/01/2021,31,848,24,698,0.016,7,150,0.003,43093,POINT (-87.808283 41.921777),60707-20210201
60707,02/02/2021,61,909,43,741,0.017,18,168,0.004,43093,POINT (-87.808283 41.921777),60707-20210202
60707,02/03/2021,59,968,48,789,0.018,11,179,0.004,43093,POINT (-87.808283 41.921777),60707-20210203
60707,02/04/2021,57,1025,53,842,0.02,4,183,0.004,43093,POINT (-87.808283 41.921777),60707-20210204
Unknown,02/03/2021,59,1051,27,862,0,32,189,0,0,,Unknown-20210203
Unknown,02/04/2021,63,1114,32,894,0,31,220,0,0,,Unknown-20210204
60601,02/05/2021,37,2093,28,1515,0.1,9,578,0.038,15083,POINT (-87.622844 41.886262),60601-20210205
60606,02/05/2021,13,559,8,398,0.121,5,161,0.049,3287,POINT (-87.63676 41.882634),60606-20210205
60611,02/05/2021,112,9247,84,6363,0.192,28,2884,0.087,33224,POINT (-87.620291 41.894734),60611-20210205
60666,02/05/2021,0,14,0,14,0,0,0,0,0,POINT (-87.896371 41.979511),60666-20210205
60645,02/05/2021,132,4799,99,3789,0.08,33,1010,0.021,47270,POINT (-87.695049 42.008927),60645-20210205
60625,02/05/2021,239,7377,159,5681,0.072,80,1696,0.021,79444,POINT (-87.701816 41.971155),60625-20210205
60640,02/05/2021,218,9411,143,7333,0.106,75,2078,0.03,69363,POINT (-87.662232 41.971888),60640-20210205
60626,02/05/2021,126,5245,78,4092,0.081,48,1153,0.023,50544,POINT (-87.669834 42.009469),60626-20210205
60657,02/05/2021,245,10656,166,7658,0.108,79,2998,0.042,70958,POINT (-87.658216 41.939715),60657-20210205
60615,02/05/2021,84,6565,63,4737,0.117,21,1828,0.045,40590,POINT (-87.602725 41.801993),60615-20210205
60621,02/05/2021,24,1159,22,951,0.034,2,208,0.007,28018,POINT (-87.638812 41.776931),60621-20210205
60651,02/05/2021,108,2708,89,2275,0.036,19,433,0.007,63492,POINT (-87.741017 41.901964),60651-20210205
60707,02/05/2021,38,1063,27,869,0.02,11,194,0.005,43093,POINT (-87.808283 41.921777),60707-20210205
60631,02/05/2021,132,3719,124,2965,0.1,8,754,0.026,29529,POINT (-87.813371 41.995019),60631-20210205
60602,02/05/2021,5,344,4,272,0.238,1,72,0.063,1145,POINT (-87.628309 41.883136),60602-20210205
60607,02/05/2021,127,6142,75,4104,0.14,52,2038,0.07,29293,POINT (-87.652727 41.876104),60607-20210205
60630,02/05/2021,162,4758,128,3663,0.065,34,1095,0.019,56433,POINT (-87.759611 41.971261),60630-20210205
60641,02/05/2021,163,5060,126,3936,0.056,37,1124,0.016,69880,POINT (-87.746791 41.946682),60641-20210205
60622,02/05/2021,182,8300,119,5853,0.11,63,2447,0.046,53294,POINT (-87.681818 41.902762),60622-20210205
60636,02/05/2021,47,1019,42,882,0.029,5,137,0.005,30024,POINT (-87.668597 41.77599),60636-20210205
60610,02/05/2021,124,5561,93,4218,0.104,31,1343,0.033,40548,POINT (-87.63581 41.90455),60610-20210205
60659,02/05/2021,102,3358,69,2647,0.062,33,711,0.017,42735,POINT (-87.703266 41.990803),60659-20210205
60614,02/05/2021,184,9861,145,7355,0.102,39,2506,0.035,71954,POINT (-87.652064 41.922605),60614-20210205
60644,02/05/2021,51,2587,45,2064,0.044,6,523,0.011,46591,POINT (-87.756863 41.881113),60644-20210205
60603,02/05/2021,5,380,0,320,0.304,5,60,0.057,1052,POINT (-87.625473 41.880112),60603-20210205
60634,02/05/2021,217,5827,163,4571,0.061,54,1256,0.017,75082,POINT (-87.797373 41.944967),60634-20210205
60637,02/05/2021,68,4326,54,3322,0.07,14,1004,0.021,47300,POINT (-87.604053 41.780991),60637-20210205
60649,02/05/2021,75,3066,59,2620,0.056,16,446,0.01,46633,POINT (-87.571522 41.762202),60649-20210205
60618,02/05/2021,277,8868,207,6677,0.07,70,2191,0.023,94907,POINT (-87.703343 41.946699),60618-20210205
60623,02/05/2021,248,4053,212,3366,0.041,36,687,0.008,81283,POINT (-87.717446 41.850321),60623-20210205
60647,02/05/2021,256,8318,193,6365,0.073,63,1953,0.022,87633,POINT (-87.701101 41.921058),60647-20210205
Unknown,02/05/2021,65,1179,22,916,0,43,263,0,0,,Unknown-20210205
60629,02/05/2021,303,5044,271,4182,0.038,32,862,0.008,110029,POINT (-87.711565 41.777061),60629-20210205
60613,02/05/2021,168,6941,115,5138,0.101,53,1803,0.036,50761,POINT (-87.661343 41.953742),60613-20210205
60660,02/05/2021,117,4928,82,3867,0.087,35,1061,0.024,44498,POINT (-87.666362 41.991062),60660-20210205
60654,02/05/2021,61,2870,50,1974,0.099,11,896,0.045,20022,POINT (-87.636354 41.892485),60654-20210205
60608,02/05/2021,230,6908,189,5494,0.069,41,1414,0.018,80059,POINT (-87.670366 41.849879),60608-20210205
60642,02/05/2021,72,3037,41,2061,0.105,31,976,0.05,19716,POINT (-87.657821 41.899935),60642-20210205
60604,02/05/2021,6,209,4,188,0.228,2,21,0.026,823,POINT (-87.629029 41.878153),60604-20210205
60638,02/05/2021,178,4306,157,3492,0.06,21,814,0.014,58669,POINT (-87.771902 41.787032),60638-20210205
60653,02/05/2021,54,2616,46,2122,0.064,8,494,0.015,33154,POINT (-87.611244 41.819261),60653-20210205
60619,02/05/2021,120,3674,105,3179,0.052,15,495,0.008,61207,POINT (-87.60569 41.744737),60619-20210205
60655,02/05/2021,144,3989,137,3141,0.11,7,848,0.03,28569,POINT (-87.701434 41.696456),60655-20210205
60617,02/05/2021,198,4539,138,3865,0.046,60,674,0.008,83553,POINT (-87.556897 41.721257),60617-20210205
60633,02/05/2021,24,528,20,439,0.035,4,89,0.007,12689,POINT (-87.556037 41.653147),60633-20210205
60612,02/05/2021,131,4240,77,2975,0.088,54,1265,0.037,33735,POINT (-87.687011 41.88004),60612-20210205
60646,02/05/2021,150,3516,125,2806,0.098,25,710,0.025,28569,POINT (-87.761826 41.993931),60646-20210205
60643,02/05/2021,166,4651,147,3864,0.079,19,787,0.016,48887,POINT (-87.662381 41.700445),60643-20210205
60628,02/05/2021,112,3025,101,2540,0.04,11,485,0.008,64254,POINT (-87.621537 41.694192),60628-20210205
60661,02/05/2021,51,1750,33,1138,0.11,18,612,0.059,10354,POINT (-87.644283 41.882786),60661-20210205
60624,02/05/2021,42,1456,35,1228,0.035,7,228,0.007,34892,POINT (-87.722735 41.879417),60624-20210205
60609,02/05/2021,134,3285,114,2653,0.044,20,632,0.01,60939,POINT (-87.653382 41.812017),60609-20210205
60827,02/05/2021,3,102,3,84,0.003,0,18,0.001,28483,POINT (-87.633087 41.650765),60827-20210205
60639,02/05/2021,181,3908,160,3188,0.036,21,720,0.008,88204,POINT (-87.75531 41.920609),60639-20210205
60632,02/05/2021,247,4343,227,3705,0.041,20,638,0.007,89857,POINT (-87.711251 41.810038),60632-20210205
60656,02/05/2021,82,1952,73,1530,0.054,9,422,0.015,28218,POINT (-87.817934 41.974566),60656-20210205
60620,02/05/2021,103,3096,91,2544,0.038,12,552,0.008,67711,POINT (-87.651656 41.740873),60620-20210205
60605,02/05/2021,110,6001,80,3995,0.137,30,2006,0.069,29060,POINT (-87.623449 41.867824),60605-20210205
60652,02/05/2021,129,2643,125,2072,0.048,4,571,0.013,43447,POINT (-87.714238 41.745398),60652-20210205
60616,02/05/2021,176,5848,134,4425,0.082,42,1423,0.026,54197,POINT (-87.629531 41.844869),60616-20210205
60620,01/20/2021,80,1077,56,891,0.013,24,186,0.003,67711,POINT (-87.651656 41.740873),60620-20210120
60645,12/28/2020,31,316,31,316,0.007,0,0,0,47270,POINT (-87.695049 42.008927),60645-20201228
60661,01/06/2021,28,565,17,548,0.053,11,17,0.002,10354,POINT (-87.644283 41.882786),60661-20210106
60631,12/16/2020,3,3,3,3,0,0,0,0,29529,POINT (-87.813371 41.995019),60631-20201216
60653,12/17/2020,10,10,10,10,0,0,0,0,33154,POINT (-87.611244 41.819261),60653-20201217
60616,12/24/2020,32,644,32,644,0.012,0,0,0,54197,POINT (-87.629531 41.844869),60616-20201224
60639,01/13/2021,84,1153,57,967,0.011,27,186,0.002,88204,POINT (-87.75531 41.920609),60639-20210113
60609,01/13/2021,58,882,31,719,0.012,27,163,0.003,60939,POINT (-87.653382 41.812017),60609-20210113
60636,01/02/2021,4,86,4,86,0.003,0,0,0,30024,POINT (-87.668597 41.77599),60636-20210102
60622,12/20/2020,53,748,53,748,0.014,0,0,0,53294,POINT (-87.681818 41.902762),60622-20201220
60629,12/26/2020,9,285,9,285,0.003,0,0,0,110029,POINT (-87.711565 41.777061),60629-20201226
60656,12/27/2020,0,196,0,196,0.007,0,0,0,28218,POINT (-87.817934 41.974566),60656-20201227
60630,01/03/2021,7,679,7,679,0.012,0,0,0,56433,POINT (-87.759611 41.971261),60630-20210103
60607,12/30/2020,171,1348,171,1348,0.046,0,0,0,29293,POINT (-87.652727 41.876104),60607-20201230
60660,01/12/2021,119,1977,83,1707,0.038,36,270,0.006,44498,POINT (-87.666362 41.991062),60660-20210112
60628,01/03/2021,6,240,5,239,0.004,1,1,0,64254,POINT (-87.621537 41.694192),60628-20210103
60620,01/08/2021,82,613,55,553,0.008,27,60,0.001,67711,POINT (-87.651656 41.740873),60620-20210108
60666,01/23/2021,0,2,0,2,0,0,0,0,0,POINT (-87.896371 41.979511),60666-20210123
60623,01/02/2021,13,403,13,403,0.005,0,0,0,81283,POINT (-87.717446 41.850321),60623-20210102
60633,01/17/2021,0,135,0,110,0.009,0,25,0.002,12689,POINT (-87.556037 41.653147),60633-20210117
60643,01/06/2021,150,700,130,673,0.014,20,27,0.001,48887,POINT (-87.662381 41.700445),60643-20210106
60649,12/21/2020,13,61,13,61,0.001,0,0,0,46633,POINT (-87.571522 41.762202),60649-20201221
60644,01/15/2021,26,916,21,851,0.018,5,65,0.001,46591,POINT (-87.756863 41.881113),60644-20210115
60602,12/16/2020,0,0,0,0,0,0,0,0,1145,POINT (-87.628309 41.883136),60602-20201216
60644,12/24/2020,4,82,4,82,0.002,0,0,0,46591,POINT (-87.756863 41.881113),60644-20201224
60630,12/19/2020,81,210,81,210,0.004,0,0,0,56433,POINT (-87.759611 41.971261),60630-20201219
60642,01/15/2021,58,1588,47,1087,0.055,11,501,0.025,19716,POINT (-87.657821 41.899935),60642-20210115
60637,01/01/2021,1,619,1,619,0.013,0,0,0,47300,POINT (-87.604053 41.780991),60637-20210101
60647,12/28/2020,58,1037,58,1037,0.012,0,0,0,87633,POINT (-87.701101 41.921058),60647-20201228
60632,12/24/2020,11,154,11,154,0.002,0,0,0,89857,POINT (-87.711251 41.810038),60632-20201224
60606,01/31/2021,2,488,1,344,0.105,1,144,0.044,3287,POINT (-87.63676 41.882634),60606-20210131
60636,01/13/2021,19,210,15,188,0.006,4,22,0.001,30024,POINT (-87.668597 41.77599),60636-20210113
60652,12/27/2020,0,156,0,156,0.004,0,0,0,43447,POINT (-87.714238 41.745398),60652-20201227
60666,01/10/2021,0,0,0,0,0,0,0,0,0,POINT (-87.896371 41.979511),60666-20210110
60609,01/02/2021,5,340,5,340,0.006,0,0,0,60939,POINT (-87.653382 41.812017),60609-20210102
60618,12/24/2020,38,914,38,914,0.01,0,0,0,94907,POINT (-87.703343 41.946699),60618-20201224
60707,01/05/2021,11,144,11,143,0.003,0,1,0,43093,POINT (-87.808283 41.921777),60707-20210105
60606,01/17/2021,2,277,2,187,0.057,0,90,0.027,3287,POINT (-87.63676 41.882634),60606-20210117
60621,01/17/2021,1,319,1,288,0.01,0,31,0.001,28018,POINT (-87.638812 41.776931),60621-20210117
60622,12/25/2020,0,1358,0,1358,0.025,0,0,0,53294,POINT (-87.681818 41.902762),60622-20201225
60653,12/28/2020,23,191,23,191,0.006,0,0,0,33154,POINT (-87.611244 41.819261),60653-20201228
60620,01/15/2021,36,870,32,737,0.011,4,133,0.002,67711,POINT (-87.651656 41.740873),60620-20210115
60623,01/13/2021,68,998,35,870,0.011,33,128,0.002,81283,POINT (-87.717446 41.850321),60623-20210113
60647,01/14/2021,268,3529,234,2629,0.03,34,900,0.01,87633,POINT (-87.701101 41.921058),60647-20210114
60653,01/14/2021,69,911,61,754,0.023,8,157,0.005,33154,POINT (-87.611244 41.819261),60653-20210114
60610,01/02/2021,34,934,34,934,0.023,0,0,0,40548,POINT (-87.63581 41.90455),60610-20210102
60639,12/15/2020,0,0,0,0,0,0,0,0,88204,POINT (-87.75531 41.920609),60639-20201215
60619,12/27/2020,0,121,0,121,0.002,0,0,0,61207,POINT (-87.60569 41.744737),60619-20201227
60655,12/24/2020,9,372,9,372,0.013,0,0,0,28569,POINT (-87.701434 41.696456),60655-20201224
Unknown,12/15/2020,0,0,0,0,0,0,0,0,0,,Unknown-20201215
60638,01/02/2021,27,566,27,566,0.01,0,0,0,58669,POINT (-87.771902 41.787032),60638-20210102
60641,12/21/2020,86,301,86,301,0.004,0,0,0,69880,POINT (-87.746791 41.946682),60641-20201221
60641,12/15/2020,0,0,0,0,0,0,0,0,69880,POINT (-87.746791 41.946682),60641-20201215
60632,12/19/2020,10,47,10,47,0.001,0,0,0,89857,POINT (-87.711251 41.810038),60632-20201219
Unknown,12/19/2020,1,9,1,9,0,0,0,0,0,,Unknown-20201219
60605,01/10/2021,61,2634,7,1946,0.067,54,688,0.024,29060,POINT (-87.623449 41.867824),60605-20210110
60607,12/17/2020,100,105,100,105,0.004,0,0,0,29293,POINT (-87.652727 41.876104),60607-20201217
60647,12/15/2020,0,0,0,0,0,0,0,0,87633,POINT (-87.701101 41.921058),60647-20201215
60651,12/28/2020,29,141,29,141,0.002,0,0,0,63492,POINT (-87.741017 41.901964),60651-20201228
60639,12/20/2020,5,89,5,89,0.001,0,0,0,88204,POINT (-87.75531 41.920609),60639-20201220
60624,12/15/2020,0,0,0,0,0,0,0,0,34892,POINT (-87.722735 41.879417),60624-20201215
60609,01/15/2021,36,961,28,786,0.013,8,175,0.003,60939,POINT (-87.653382 41.812017),60609-20210115
60637,12/15/2020,0,0,0,0,0,0,0,0,47300,POINT (-87.604053 41.780991),60637-20201215
60608,12/23/2020,76,532,76,532,0.007,0,0,0,80059,POINT (-87.670366 41.849879),60608-20201223
60610,01/07/2021,108,1289,29,1181,0.029,79,108,0.003,40548,POINT (-87.63581 41.90455),60610-20210107
60639,01/16/2021,53,1352,50,1149,0.013,3,203,0.002,88204,POINT (-87.75531 41.920609),60639-20210116
60624,12/26/2020,1,59,1,59,0.002,0,0,0,34892,POINT (-87.722735 41.879417),60624-20201226
60640,01/08/2021,486,2566,348,2322,0.033,138,244,0.004,69363,POINT (-87.662232 41.971888),60640-20210108
60623,12/23/2020,33,145,33,145,0.002,0,0,0,81283,POINT (-87.717446 41.850321),60623-20201223
60649,12/24/2020,14,118,14,118,0.003,0,0,0,46633,POINT (-87.571522 41.762202),60649-20201224
60827,01/10/2021,0,19,0,17,0.001,0,2,0,28483,POINT (-87.633087 41.650765),60827-20210110
60646,01/15/2021,53,1238,49,938,0.033,4,300,0.011,28569,POINT (-87.761826 41.993931),60646-20210115
60651,01/15/2021,43,698,39,599,0.009,4,99,0.002,63492,POINT (-87.741017 41.901964),60651-20210115
60620,12/20/2020,3,68,3,68,0.001,0,0,0,67711,POINT (-87.651656 41.740873),60620-20201220
60646,12/25/2020,0,306,0,306,0.011,0,0,0,28569,POINT (-87.761826 41.993931),60646-20201225
60644,01/01/2021,0,212,0,212,0.005,0,0,0,46591,POINT (-87.756863 41.881113),60644-20210101
60629,12/21/2020,45,167,45,167,0.002,0,0,0,110029,POINT (-87.711565 41.777061),60629-20201221
60602,12/30/2020,5,44,5,44,0.038,0,0,0,1145,POINT (-87.628309 41.883136),60602-20201230
60644,12/19/2020,7,25,7,25,0.001,0,0,0,46591,POINT (-87.756863 41.881113),60644-20201219
60656,01/06/2021,24,382,18,376,0.013,6,6,0,28218,POINT (-87.817934 41.974566),60656-20210106
60621,01/02/2021,1,180,1,180,0.006,0,0,0,28018,POINT (-87.638812 41.776931),60621-20210102
60661,12/23/2020,27,340,27,340,0.033,0,0,0,10354,POINT (-87.644283 41.882786),60661-20201223
60625,01/03/2021,147,1165,147,1165,0.015,0,0,0,79444,POINT (-87.701816 41.971155),60625-20210103
60707,12/23/2020,15,71,15,71,0.002,0,0,0,43093,POINT (-87.808283 41.921777),60707-20201223
60643,12/27/2020,1,313,1,313,0.006,0,0,0,48887,POINT (-87.662381 41.700445),60643-20201227
60629,01/06/2021,46,702,40,693,0.006,6,9,0,110029,POINT (-87.711565 41.777061),60629-20210106
60638,12/23/2020,34,311,34,311,0.005,0,0,0,58669,POINT (-87.771902 41.787032),60638-20201223
60657,12/24/2020,50,1439,50,1439,0.02,0,0,0,70958,POINT (-87.658216 41.939715),60657-20201224
60633,01/02/2021,5,53,5,53,0.004,0,0,0,12689,POINT (-87.556037 41.653147),60633-20210102
60660,01/10/2021,11,1786,6,1594,0.036,5,192,0.004,44498,POINT (-87.666362 41.991062),60660-20210110
60827,12/18/2020,4,4,4,4,0,0,0,0,28483,POINT (-87.633087 41.650765),60827-20201218
60647,01/16/2021,116,3791,107,2863,0.033,9,928,0.011,87633,POINT (-87.701101 41.921058),60647-20210116
60629,12/16/2020,2,2,2,2,0,0,0,0,110029,POINT (-87.711565 41.777061),60629-20201216
60606,12/23/2020,4,88,4,88,0.027,0,0,0,3287,POINT (-87.63676 41.882634),60606-20201223
60632,01/03/2021,6,421,6,421,0.005,0,0,0,89857,POINT (-87.711251 41.810038),60632-20210103
60621,01/07/2021,15,234,12,226,0.008,3,8,0,28018,POINT (-87.638812 41.776931),60621-20210107
60657,01/05/2021,219,2555,206,2532,0.036,13,23,0,70958,POINT (-87.658216 41.939715),60657-20210105
60642,12/29/2020,52,598,52,598,0.03,0,0,0,19716,POINT (-87.657821 41.899935),60642-20201229
Unknown,12/20/2020,1,10,1,10,0,0,0,0,0,,Unknown-20201220
60636,01/12/2021,14,191,10,173,0.006,4,18,0.001,30024,POINT (-87.668597 41.77599),60636-20210112
60617,01/07/2021,57,579,33,544,0.007,24,35,0,83553,POINT (-87.556897 41.721257),60617-20210107
60624,12/20/2020,1,24,1,24,0.001,0,0,0,34892,POINT (-87.722735 41.879417),60624-20201220
60602,01/04/2021,3,50,3,50,0.044,0,0,0,1145,POINT (-87.628309 41.883136),60602-20210104
60644,12/29/2020,29,172,29,172,0.004,0,0,0,46591,POINT (-87.756863 41.881113),60644-20201229
60617,01/12/2021,87,837,57,691,0.008,30,146,0.002,83553,POINT (-87.556897 41.721257),60617-20210112
60613,12/20/2020,16,402,16,402,0.008,0,0,0,50761,POINT (-87.661343 41.953742),60613-20201220
60610,12/26/2020,15,657,15,657,0.016,0,0,0,40548,POINT (-87.63581 41.90455),60610-20201226
60605,01/03/2021,33,1596,29,1592,0.055,4,4,0,29060,POINT (-87.623449 41.867824),60605-20210103
60666,12/19/2020,0,0,0,0,0,0,0,0,0,POINT (-87.896371 41.979511),60666-20201219
60621,01/12/2021,20,283,15,259,0.009,5,24,0.001,28018,POINT (-87.638812 41.776931),60621-20210112
60612,12/29/2020,83,667,83,667,0.02,0,0,0,33735,POINT (-87.687011 41.88004),60612-20201229
60610,01/17/2021,20,2313,13,1650,0.041,7,663,0.016,40548,POINT (-87.63581 41.90455),60610-20210117
60623,01/07/2021,49,668,39,652,0.008,10,16,0,81283,POINT (-87.717446 41.850321),60623-20210107
60626,12/20/2020,8,167,8,167,0.003,0,0,0,50544,POINT (-87.669834 42.009469),60626-20201220
60629,01/10/2021,17,942,4,827,0.008,13,115,0.001,110029,POINT (-87.711565 41.777061),60629-20210110
60642,01/19/2021,62,1747,28,1175,0.06,34,572,0.029,19716,POINT (-87.657821 41.899935),60642-20210119
60651,01/14/2021,39,655,36,560,0.009,3,95,0.001,63492,POINT (-87.741017 41.901964),60651-20210114
60617,12/26/2020,3,202,3,202,0.002,0,0,0,83553,POINT (-87.556897 41.721257),60617-20201226
Unknown,12/25/2020,0,37,0,37,0,0,0,0,0,,Unknown-20201225
60636,12/20/2020,0,8,0,8,0,0,0,0,30024,POINT (-87.668597 41.77599),60636-20201220
60633,12/23/2020,4,23,4,23,0.002,0,0,0,12689,POINT (-87.556037 41.653147),60633-20201223
60656,12/22/2020,16,177,16,177,0.006,0,0,0,28218,POINT (-87.817934 41.974566),60656-20201222
60637,12/21/2020,34,177,34,177,0.004,0,0,0,47300,POINT (-87.604053 41.780991),60637-20201221
60626,12/25/2020,0,332,0,332,0.007,0,0,0,50544,POINT (-87.669834 42.009469),60626-20201225
60611,12/15/2020,0,0,0,0,0,0,0,0,33224,POINT (-87.620291 41.894734),60611-20201215
60707,01/02/2021,2,122,2,122,0.003,0,0,0,43093,POINT (-87.808283 41.921777),60707-20210102
60636,01/19/2021,19,273,14,237,0.008,5,36,0.001,30024,POINT (-87.668597 41.77599),60636-20210119
60639,01/01/2021,0,377,0,377,0.004,0,0,0,88204,POINT (-87.75531 41.920609),60639-20210101
60610,12/15/2020,0,0,0,0,0,0,0,0,40548,POINT (-87.63581 41.90455),60610-20201215
60609,01/06/2021,133,544,127,535,0.009,6,9,0,60939,POINT (-87.653382 41.812017),60609-20210106
60623,12/29/2020,49,299,49,299,0.004,0,0,0,81283,POINT (-87.717446 41.850321),60623-20201229
60625,12/25/2020,0,623,0,623,0.008,0,0,0,79444,POINT (-87.701816 41.971155),60625-20201225
60640,01/03/2021,98,1290,98,1290,0.019,0,0,0,69363,POINT (-87.662232 41.971888),60640-20210103
60649,12/31/2020,12,306,12,306,0.007,0,0,0,46633,POINT (-87.571522 41.762202),60649-20201231
60614,12/30/2020,141,1750,141,1750,0.024,0,0,0,71954,POINT (-87.652064 41.922605),60614-20201230
60633,01/24/2021,6,250,5,202,0.016,1,48,0.004,12689,POINT (-87.556037 41.653147),60633-20210124
60644,01/25/2021,125,1365,71,1188,0.025,54,177,0.004,46591,POINT (-87.756863 41.881113),60644-20210125
60645,01/02/2021,13,654,13,654,0.014,0,0,0,47270,POINT (-87.695049 42.008927),60645-20210102
60639,01/06/2021,60,599,54,589,0.007,6,10,0,88204,POINT (-87.75531 41.920609),60639-20210106
60653,01/10/2021,13,671,3,588,0.018,10,83,0.003,33154,POINT (-87.611244 41.819261),60653-20210110
60616,12/29/2020,76,787,76,787,0.015,0,0,0,54197,POINT (-87.629531 41.844869),60616-20201229
60656,01/11/2021,40,578,9,424,0.015,31,154,0.005,28218,POINT (-87.817934 41.974566),60656-20210111
60653,12/24/2020,9,168,9,168,0.005,0,0,0,33154,POINT (-87.611244 41.819261),60653-20201224
60637,12/26/2020,4,363,4,363,0.008,0,0,0,47300,POINT (-87.604053 41.780991),60637-20201226
60618,12/28/2020,71,1010,71,1010,0.011,0,0,0,94907,POINT (-87.703343 41.946699),60618-20201228
60707,12/16/2020,1,1,1,1,0,0,0,0,43093,POINT (-87.808283 41.921777),60707-20201216
60621,12/28/2020,60,94,60,94,0.003,0,0,0,28018,POINT (-87.638812 41.776931),60621-20201228
60641,12/19/2020,56,200,56,200,0.003,0,0,0,69880,POINT (-87.746791 41.946682),60641-20201219
60606,01/24/2021,4,373,4,251,0.076,0,122,0.037,3287,POINT (-87.63676 41.882634),60606-20210124
60618,01/14/2021,166,3442,127,2572,0.027,39,870,0.009,94907,POINT (-87.703343 41.946699),60618-20210114
60628,12/19/2020,10,38,10,38,0.001,0,0,0,64254,POINT (-87.621537 41.694192),60628-20201219
60640,12/29/2020,103,894,103,894,0.013,0,0,0,69363,POINT (-87.662232 41.971888),60640-20201229
60631,12/22/2020,30,310,30,310,0.01,0,0,0,29529,POINT (-87.813371 41.995019),60631-20201222
60632,01/10/2021,8,693,1,639,0.007,7,54,0.001,89857,POINT (-87.711251 41.810038),60632-20210110
60651,12/25/2020,0,109,0,109,0.002,0,0,0,63492,POINT (-87.741017 41.901964),60651-20201225
60630,12/23/2020,49,413,49,413,0.007,0,0,0,56433,POINT (-87.759611 41.971261),60630-20201223
60637,01/16/2021,99,1682,53,1273,0.027,46,409,0.009,47300,POINT (-87.604053 41.780991),60637-20210116
60646,01/11/2021,63,911,12,695,0.024,51,216,0.008,28569,POINT (-87.761826 41.993931),60646-20210111
Unknown,01/26/2021,44,744,31,642,0,13,102,0,0,,Unknown-20210126
60608,12/19/2020,72,225,72,225,0.003,0,0,0,80059,POINT (-87.670366 41.849879),60608-20201219
60646,12/31/2020,35,457,35,457,0.016,0,0,0,28569,POINT (-87.761826 41.993931),60646-20201231
60620,12/16/2020,0,0,0,0,0,0,0,0,67711,POINT (-87.651656 41.740873),60620-20201216
60827,01/06/2021,2,13,2,13,0,0,0,0,28483,POINT (-87.633087 41.650765),60827-20210106
60660,12/28/2020,36,382,36,382,0.009,0,0,0,44498,POINT (-87.666362 41.991062),60660-20201228
60827,01/19/2021,3,39,3,34,0.001,0,5,0,28483,POINT (-87.633087 41.650765),60827-20210119
60614,12/24/2020,30,1281,30,1281,0.018,0,0,0,71954,POINT (-87.652064 41.922605),60614-20201224
60642,01/04/2021,45,755,41,751,0.038,4,4,0,19716,POINT (-87.657821 41.899935),60642-20210104
60608,01/01/2021,0,910,0,910,0.011,0,0,0,80059,POINT (-87.670366 41.849879),60608-20210101
Unknown,01/08/2021,9,137,4,130,0,5,7,0,0,,Unknown-20210108
60619,01/07/2021,31,422,22,406,0.007,9,16,0,61207,POINT (-87.60569 41.744737),60619-20210107
60625,12/30/2020,134,900,134,900,0.011,0,0,0,79444,POINT (-87.701816 41.971155),60625-20201230
60640,12/19/2020,95,310,95,310,0.004,0,0,0,69363,POINT (-87.662232 41.971888),60640-20201219
60640,01/05/2021,143,1631,136,1617,0.023,7,14,0,69363,POINT (-87.662232 41.971888),60640-20210105
60633,12/28/2020,4,30,4,30,0.002,0,0,0,12689,POINT (-87.556037 41.653147),60633-20201228
60642,12/25/2020,0,509,0,509,0.026,0,0,0,19716,POINT (-87.657821 41.899935),60642-20201225
60608,01/20/2021,304,2998,216,2282,0.029,88,716,0.009,80059,POINT (-87.670366 41.849879),60608-20210120
60666,01/20/2021,0,2,0,2,0,0,0,0,0,POINT (-87.896371 41.979511),60666-20210120
60628,12/24/2020,10,111,10,111,0.002,0,0,0,64254,POINT (-87.621537 41.694192),60628-20201224
60633,12/16/2020,0,0,0,0,0,0,0,0,12689,POINT (-87.556037 41.653147),60633-20201216
60633,01/29/2021,39,382,38,314,0.025,1,68,0.005,12689,POINT (-87.556037 41.653147),60633-20210129
60606,12/16/2020,0,0,0,0,0,0,0,0,3287,POINT (-87.63676 41.882634),60606-20201216
60644,01/20/2021,60,1046,42,935,0.02,18,111,0.002,46591,POINT (-87.756863 41.881113),60644-20210120
60636,01/08/2021,23,163,17,152,0.005,6,11,0,30024,POINT (-87.668597 41.77599),60636-20210108
60645,01/07/2021,108,1134,68,1084,0.023,40,50,0.001,47270,POINT (-87.695049 42.008927),60645-20210107
60606,01/04/2021,10,139,7,136,0.041,3,3,0.001,3287,POINT (-87.63676 41.882634),60606-20210104
Unknown,01/21/2021,103,620,99,537,0,4,83,0,0,,Unknown-20210121
60628,12/31/2020,16,231,16,231,0.004,0,0,0,64254,POINT (-87.621537 41.694192),60628-20201231
60652,12/15/2020,1,1,1,1,0,0,0,0,43447,POINT (-87.714238 41.745398),60652-20201215
60643,01/01/2021,0,456,0,456,0.009,0,0,0,48887,POINT (-87.662381 41.700445),60643-20210101
60661,01/09/2021,66,787,7,599,0.058,59,188,0.018,10354,POINT (-87.644283 41.882786),60661-20210109
60661,01/03/2021,7,478,7,478,0.046,0,0,0,10354,POINT (-87.644283 41.882786),60661-20210103
60638,12/18/2020,73,95,73,95,0.002,0,0,0,58669,POINT (-87.771902 41.787032),60638-20201218
60636,12/18/2020,5,8,5,8,0,0,0,0,30024,POINT (-87.668597 41.77599),60636-20201218
60652,12/20/2020,12,63,12,63,0.001,0,0,0,43447,POINT (-87.714238 41.745398),60652-20201220
60605,12/22/2020,218,1030,218,1030,0.035,0,0,0,29060,POINT (-87.623449 41.867824),60605-20201222
60633,01/07/2021,15,89,6,79,0.006,9,10,0.001,12689,POINT (-87.556037 41.653147),60633-20210107
60625,12/19/2020,97,294,97,294,0.004,0,0,0,79444,POINT (-87.701816 41.971155),60625-20201219
Unknown,01/09/2021,12,149,11,141,0,1,8,0,0,,Unknown-20210109
60629,01/14/2021,94,1313,81,1065,0.01,13,248,0.002,110029,POINT (-87.711565 41.777061),60629-20210114
60666,01/03/2021,0,0,0,0,0,0,0,0,0,POINT (-87.896371 41.979511),60666-20210103
60613,12/16/2020,7,7,7,7,0,0,0,0,50761,POINT (-87.661343 41.953742),60613-20201216
60827,12/22/2020,2,6,2,6,0,0,0,0,28483,POINT (-87.633087 41.650765),60827-20201222
60642,01/23/2021,41,2054,37,1394,0.071,4,660,0.033,19716,POINT (-87.657821 41.899935),60642-20210123
60657,12/19/2020,223,716,223,716,0.01,0,0,0,70958,POINT (-87.658216 41.939715),60657-20201219
60647,01/03/2021,20,1404,20,1404,0.016,0,0,0,87633,POINT (-87.701101 41.921058),60647-20210103
60633,01/12/2021,7,112,4,93,0.007,3,19,0.001,12689,POINT (-87.556037 41.653147),60633-20210112
60649,01/12/2021,95,785,80,709,0.015,15,76,0.002,46633,POINT (-87.571522 41.762202),60649-20210112
60621,12/20/2020,3,18,3,18,0.001,0,0,0,28018,POINT (-87.638812 41.776931),60621-20201220
60629,12/24/2020,16,276,16,276,0.003,0,0,0,110029,POINT (-87.711565 41.777061),60629-20201224
Unknown,12/29/2020,17,59,17,59,0,0,0,0,0,,Unknown-20201229
60636,12/24/2020,2,29,2,29,0.001,0,0,0,30024,POINT (-87.668597 41.77599),60636-20201224
60656,12/18/2020,58,68,58,68,0.002,0,0,0,28218,POINT (-87.817934 41.974566),60656-20201218
60707,12/31/2020,6,120,6,120,0.003,0,0,0,43093,POINT (-87.808283 41.921777),60707-20201231
60661,12/29/2020,33,406,33,406,0.039,0,0,0,10354,POINT (-87.644283 41.882786),60661-20201229
60637,12/25/2020,0,359,0,359,0.008,0,0,0,47300,POINT (-87.604053 41.780991),60637-20201225
60657,01/01/2021,4,2058,4,2058,0.029,0,0,0,70958,POINT (-87.658216 41.939715),60657-20210101
60614,01/03/2021,35,1882,35,1882,0.026,0,0,0,71954,POINT (-87.652064 41.922605),60614-20210103
60660,12/20/2020,8,183,8,183,0.004,0,0,0,44498,POINT (-87.666362 41.991062),60660-20201220
60607,01/06/2021,77,1769,52,1722,0.059,25,47,0.002,29293,POINT (-87.652727 41.876104),60607-20210106
60610,12/19/2020,98,322,98,322,0.008,0,0,0,40548,POINT (-87.63581 41.90455),60610-20201219
60639,01/05/2021,64,539,63,535,0.006,1,4,0,88204,POINT (-87.75531 41.920609),60639-20210105
60602,12/25/2020,0,30,0,30,0.026,0,0,0,1145,POINT (-87.628309 41.883136),60602-20201225
60625,12/29/2020,67,766,67,766,0.01,0,0,0,79444,POINT (-87.701816 41.971155),60625-20201229
60632,01/11/2021,46,739,22,661,0.007,24,78,0.001,89857,POINT (-87.711251 41.810038),60632-20210111
60640,12/22/2020,133,599,133,599,0.009,0,0,0,69363,POINT (-87.662232 41.971888),60640-20201222
60647,01/08/2021,294,2203,84,1823,0.021,210,380,0.004,87633,POINT (-87.701101 41.921058),60647-20210108
60639,12/25/2020,0,215,0,215,0.002,0,0,0,88204,POINT (-87.75531 41.920609),60639-20201225
60644,01/10/2021,7,649,4,625,0.013,3,24,0.001,46591,POINT (-87.756863 41.881113),60644-20210110
60646,01/01/2021,1,458,1,458,0.016,0,0,0,28569,POINT (-87.761826 41.993931),60646-20210101
60612,01/03/2021,10,814,10,814,0.024,0,0,0,33735,POINT (-87.687011 41.88004),60612-20210103
60631,12/26/2020,6,346,6,346,0.012,0,0,0,29529,POINT (-87.813371 41.995019),60631-20201226
60618,01/01/2021,2,1410,2,1410,0.015,0,0,0,94907,POINT (-87.703343 41.946699),60618-20210101
60614,12/17/2020,128,132,128,132,0.002,0,0,0,71954,POINT (-87.652064 41.922605),60614-20201217
60616,12/17/2020,60,63,60,63,0.001,0,0,0,54197,POINT (-87.629531 41.844869),60616-20201217
60602,01/09/2021,4,77,0,63,0.055,4,14,0.012,1145,POINT (-87.628309 41.883136),60602-20210109
60606,01/28/2021,21,450,19,315,0.096,2,135,0.041,3287,POINT (-87.63676 41.882634),60606-20210128
60626,12/28/2020,24,358,24,358,0.007,0,0,0,50544,POINT (-87.669834 42.009469),60626-20201228
60630,12/20/2020,19,229,19,229,0.004,0,0,0,56433,POINT (-87.759611 41.971261),60630-20201220
60655,12/27/2020,0,377,0,377,0.013,0,0,0,28569,POINT (-87.701434 41.696456),60655-20201227
60666,01/31/2021,0,9,0,9,0,0,0,0,0,POINT (-87.896371 41.979511),60666-20210131
60607,12/22/2020,161,844,161,844,0.029,0,0,0,29293,POINT (-87.652727 41.876104),60607-20201222
60653,12/31/2020,9,398,9,398,0.012,0,0,0,33154,POINT (-87.611244 41.819261),60653-20201231
60630,12/27/2020,0,433,0,433,0.008,0,0,0,56433,POINT (-87.759611 41.971261),60630-20201227
60621,12/24/2020,1,33,1,33,0.001,0,0,0,28018,POINT (-87.638812 41.776931),60621-20201224
60621,01/21/2021,87,449,87,402,0.014,0,47,0.002,28018,POINT (-87.638812 41.776931),60621-20210121
60640,01/06/2021,293,1924,271,1888,0.027,22,36,0.001,69363,POINT (-87.662232 41.971888),60640-20210106
60651,12/21/2020,18,66,18,66,0.001,0,0,0,63492,POINT (-87.741017 41.901964),60651-20201221
60645,01/03/2021,12,666,12,666,0.014,0,0,0,47270,POINT (-87.695049 42.008927),60645-20210103
60609,12/25/2020,0,179,0,179,0.003,0,0,0,60939,POINT (-87.653382 41.812017),60609-20201225
Unknown,01/30/2021,24,939,15,804,0,9,135,0,0,,Unknown-20210130
60616,01/01/2021,2,916,2,916,0.017,0,0,0,54197,POINT (-87.629531 41.844869),60616-20210101
60618,12/17/2020,57,60,57,60,0.001,0,0,0,94907,POINT (-87.703343 41.946699),60618-20201217
60638,12/15/2020,0,0,0,0,0,0,0,0,58669,POINT (-87.771902 41.787032),60638-20201215
60617,12/18/2020,32,57,32,57,0.001,0,0,0,83553,POINT (-87.556897 41.721257),60617-20201218
60628,01/13/2021,55,679,34,583,0.009,21,96,0.001,64254,POINT (-87.621537 41.694192),60628-20210113
60666,12/22/2020,0,0,0,0,0,0,0,0,0,POINT (-87.896371 41.979511),60666-20201222
60652,12/18/2020,27,40,27,40,0.001,0,0,0,43447,POINT (-87.714238 41.745398),60652-20201218
60631,12/29/2020,44,406,44,406,0.014,0,0,0,29529,POINT (-87.813371 41.995019),60631-20201229
Unknown,01/04/2021,4,93,4,93,0,0,0,0,0,,Unknown-20210104
60655,12/17/2020,41,41,41,41,0.001,0,0,0,28569,POINT (-87.701434 41.696456),60655-20201217
60636,12/19/2020,0,8,0,8,0,0,0,0,30024,POINT (-87.668597 41.77599),60636-20201219
60608,01/05/2021,68,1099,64,1089,0.014,4,10,0,80059,POINT (-87.670366 41.849879),60608-20210105
60617,01/04/2021,36,410,33,407,0.005,3,3,0,83553,POINT (-87.556897 41.721257),60617-20210104
60660,01/01/2021,1,589,1,589,0.013,0,0,0,44498,POINT (-87.666362 41.991062),60660-20210101
60633,12/24/2020,3,26,3,26,0.002,0,0,0,12689,POINT (-87.556037 41.653147),60633-20201224
60619,01/03/2021,6,280,6,280,0.005,0,0,0,61207,POINT (-87.60569 41.744737),60619-20210103
60622,12/30/2020,292,1987,292,1987,0.037,0,0,0,53294,POINT (-87.681818 41.902762),60622-20201230
60612,12/21/2020,105,325,105,325,0.01,0,0,0,33735,POINT (-87.687011 41.88004),60612-20201221
60632,01/06/2021,32,545,26,537,0.006,6,8,0,89857,POINT (-87.711251 41.810038),60632-20210106
60620,12/28/2020,25,159,25,159,0.002,0,0,0,67711,POINT (-87.651656 41.740873),60620-20201228
60645,12/23/2020,36,269,36,269,0.006,0,0,0,47270,POINT (-87.695049 42.008927),60645-20201223
60633,01/25/2021,13,263,9,211,0.017,4,52,0.004,12689,POINT (-87.556037 41.653147),60633-20210125
60608,12/31/2020,67,910,67,910,0.011,0,0,0,80059,POINT (-87.670366 41.849879),60608-20201231
60637,01/07/2021,84,1018,45,936,0.02,39,82,0.002,47300,POINT (-87.604053 41.780991),60637-20210107
60637,01/12/2021,58,1319,23,1030,0.022,35,289,0.006,47300,POINT (-87.604053 41.780991),60637-20210112
60707,01/13/2021,24,274,11,217,0.005,13,57,0.001,43093,POINT (-87.808283 41.921777),60707-20210113
60606,01/09/2021,13,202,3,156,0.047,10,46,0.014,3287,POINT (-87.63676 41.882634),60606-20210109
60640,01/15/2021,123,3858,113,3185,0.046,10,673,0.01,69363,POINT (-87.662232 41.971888),60640-20210115
60651,01/07/2021,29,393,23,383,0.006,6,10,0,63492,POINT (-87.741017 41.901964),60651-20210107
60632,01/02/2021,12,415,12,415,0.005,0,0,0,89857,POINT (-87.711251 41.810038),60632-20210102
60651,01/22/2021,117,1158,114,970,0.015,3,188,0.003,63492,POINT (-87.741017 41.901964),60651-20210122
60642,01/08/2021,146,1086,29,882,0.045,117,204,0.01,19716,POINT (-87.657821 41.899935),60642-20210108
60649,12/16/2020,0,0,0,0,0,0,0,0,46633,POINT (-87.571522 41.762202),60649-20201216
60638,12/30/2020,80,510,80,510,0.009,0,0,0,58669,POINT (-87.771902 41.787032),60638-20201230
60827,01/23/2021,0,48,0,42,0.001,0,6,0,28483,POINT (-87.633087 41.650765),60827-20210123
60606,12/31/2020,5,123,5,123,0.037,0,0,0,3287,POINT (-87.63676 41.882634),60606-20201231
60628,12/27/2020,0,112,0,112,0.002,0,0,0,64254,POINT (-87.621537 41.694192),60628-20201227
60639,01/09/2021,47,796,20,704,0.008,27,92,0.001,88204,POINT (-87.75531 41.920609),60639-20210109
60666,12/17/2020,0,0,0,0,0,0,0,0,0,POINT (-87.896371 41.979511),60666-20201217
60622,12/15/2020,0,0,0,0,0,0,0,0,53294,POINT (-87.681818 41.902762),60622-20201215
60645,01/12/2021,146,1524,120,1311,0.028,26,213,0.005,47270,POINT (-87.695049 42.008927),60645-20210112
60605,12/26/2020,8,1213,8,1213,0.042,0,0,0,29060,POINT (-87.623449 41.867824),60605-20201226
60609,01/09/2021,34,679,23,618,0.01,11,61,0.001,60939,POINT (-87.653382 41.812017),60609-20210109
Unknown,01/13/2021,54,247,44,216,0,10,31,0,0,,Unknown-20210113
60661,01/13/2021,56,973,25,652,0.063,31,321,0.031,10354,POINT (-87.644283 41.882786),60661-20210113
60653,12/21/2020,31,101,31,101,0.003,0,0,0,33154,POINT (-87.611244 41.819261),60653-20201221
60642,12/22/2020,82,442,82,442,0.022,0,0,0,19716,POINT (-87.657821 41.899935),60642-20201222
60646,01/21/2021,161,1687,136,1294,0.045,25,393,0.014,28569,POINT (-87.761826 41.993931),60646-20210121
60646,01/06/2021,32,619,26,613,0.021,6,6,0,28569,POINT (-87.761826 41.993931),60646-20210106
60618,01/08/2021,291,2388,94,2049,0.022,197,339,0.004,94907,POINT (-87.703343 41.946699),60618-20210108
60622,12/24/2020,25,1358,25,1358,0.025,0,0,0,53294,POINT (-87.681818 41.902762),60622-20201224
60827,12/15/2020,0,0,0,0,0,0,0,0,28483,POINT (-87.633087 41.650765),60827-20201215
60660,01/16/2021,62,2294,56,1959,0.044,6,335,0.008,44498,POINT (-87.666362 41.991062),60660-20210116
60656,12/31/2020,13,282,13,282,0.01,0,0,0,28218,POINT (-87.817934 41.974566),60656-20201231
60629,12/30/2020,95,495,95,495,0.004,0,0,0,110029,POINT (-87.711565 41.777061),60629-20201230
60640,12/26/2020,13,708,13,708,0.01,0,0,0,69363,POINT (-87.662232 41.971888),60640-20201226
60630,12/30/2020,74,605,74,605,0.011,0,0,0,56433,POINT (-87.759611 41.971261),60630-20201230
60626,12/17/2020,24,25,24,25,0,0,0,0,50544,POINT (-87.669834 42.009469),60626-20201217
60649,01/08/2021,152,585,133,546,0.012,19,39,0.001,46633,POINT (-87.571522 41.762202),60649-20210108
60636,12/29/2020,13,54,13,54,0.002,0,0,0,30024,POINT (-87.668597 41.77599),60636-20201229
60642,01/11/2021,75,1294,20,938,0.048,55,356,0.018,19716,POINT (-87.657821 41.899935),60642-20210111
60644,12/20/2020,5,30,5,30,0.001,0,0,0,46591,POINT (-87.756863 41.881113),60644-20201220
60638,12/26/2020,5,327,5,327,0.006,0,0,0,58669,POINT (-87.771902 41.787032),60638-20201226
60630,12/15/2020,0,0,0,0,0,0,0,0,56433,POINT (-87.759611 41.971261),60630-20201215
60628,01/07/2021,44,468,28,450,0.007,16,18,0,64254,POINT (-87.621537 41.694192),60628-20210107
60827,01/30/2021,8,80,7,68,0.002,1,12,0,28483,POINT (-87.633087 41.650765),60827-20210130
60666,01/27/2021,1,5,1,5,0,0,0,0,0,POINT (-87.896371 41.979511),60666-20210127
60606,01/05/2021,7,146,4,140,0.043,3,6,0.002,3287,POINT (-87.63676 41.882634),60606-20210105
60653,01/03/2021,11,410,11,410,0.012,0,0,0,33154,POINT (-87.611244 41.819261),60653-20210103
60628,01/17/2021,4,770,1,664,0.01,3,106,0.002,64254,POINT (-87.621537 41.694192),60628-20210117
60647,12/24/2020,36,966,36,966,0.011,0,0,0,87633,POINT (-87.701101 41.921058),60647-20201224
60657,12/15/2020,0,0,0,0,0,0,0,0,70958,POINT (-87.658216 41.939715),60657-20201215
60633,01/16/2021,4,135,2,110,0.009,2,25,0.002,12689,POINT (-87.556037 41.653147),60633-20210116
60653,12/16/2020,0,0,0,0,0,0,0,0,33154,POINT (-87.611244 41.819261),60653-20201216
60642,01/18/2021,47,1685,23,1147,0.058,24,538,0.027,19716,POINT (-87.657821 41.899935),60642-20210118
60612,01/07/2021,102,1096,44,1026,0.03,58,70,0.002,33735,POINT (-87.687011 41.88004),60612-20210107
60629,01/02/2021,17,539,17,539,0.005,0,0,0,110029,POINT (-87.711565 41.777061),60629-20210102
60605,12/18/2020,267,401,267,401,0.014,0,0,0,29060,POINT (-87.623449 41.867824),60605-20201218
60666,01/14/2021,0,1,0,1,0,0,0,0,0,POINT (-87.896371 41.979511),60666-20210114
60644,01/06/2021,34,576,32,574,0.012,2,2,0,46591,POINT (-87.756863 41.881113),60644-20210106
60646,01/20/2021,116,1526,85,1158,0.041,31,368,0.013,28569,POINT (-87.761826 41.993931),60646-20210120
60639,12/23/2020,28,202,28,202,0.002,0,0,0,88204,POINT (-87.75531 41.920609),60639-20201223
60639,12/29/2020,32,280,32,280,0.003,0,0,0,88204,POINT (-87.75531 41.920609),60639-20201229
60602,12/21/2020,5,20,5,20,0.017,0,0,0,1145,POINT (-87.628309 41.883136),60602-20201221
60707,01/09/2021,13,200,9,180,0.004,4,20,0,43093,POINT (-87.808283 41.921777),60707-20210109
60602,01/05/2021,8,58,7,57,0.05,1,1,0.001,1145,POINT (-87.628309 41.883136),60602-20210105
60610,12/29/2020,68,777,68,777,0.019,0,0,0,40548,POINT (-87.63581 41.90455),60610-20201229
60623,12/16/2020,2,2,2,2,0,0,0,0,81283,POINT (-87.717446 41.850321),60623-20201216
60620,01/04/2021,34,304,30,299,0.004,4,5,0,67711,POINT (-87.651656 41.740873),60620-20210104
60606,02/01/2021,14,502,9,353,0.107,5,149,0.045,3287,POINT (-87.63676 41.882634),60606-20210201
60647,12/19/2020,160,496,160,496,0.006,0,0,0,87633,POINT (-87.701101 41.921058),60647-20201219
60641,12/25/2020,0,428,0,428,0.006,0,0,0,69880,POINT (-87.746791 41.946682),60641-20201225
60655,12/20/2020,38,222,38,222,0.008,0,0,0,28569,POINT (-87.701434 41.696456),60655-20201220
60616,12/21/2020,92,430,92,430,0.008,0,0,0,54197,POINT (-87.629531 41.844869),60616-20201221
60607,12/18/2020,244,349,244,349,0.012,0,0,0,29293,POINT (-87.652727 41.876104),60607-20201218
60609,01/14/2021,43,925,39,758,0.012,4,167,0.003,60939,POINT (-87.653382 41.812017),60609-20210114
60619,12/31/2020,23,267,23,267,0.004,0,0,0,61207,POINT (-87.60569 41.744737),60619-20201231
60605,01/14/2021,93,3338,60,2177,0.075,33,1161,0.04,29060,POINT (-87.623449 41.867824),60605-20210114
60623,01/03/2021,7,410,7,410,0.005,0,0,0,81283,POINT (-87.717446 41.850321),60623-20210103
60621,12/16/2020,0,0,0,0,0,0,0,0,28018,POINT (-87.638812 41.776931),60621-20201216
60616,01/05/2021,154,1175,143,1153,0.021,11,22,0,54197,POINT (-87.629531 41.844869),60616-20210105
60642,01/01/2021,0,693,0,693,0.035,0,0,0,19716,POINT (-87.657821 41.899935),60642-20210101
60618,12/20/2020,24,449,24,449,0.005,0,0,0,94907,POINT (-87.703343 41.946699),60618-20201220
60623,01/17/2021,7,1134,7,993,0.012,0,141,0.002,81283,POINT (-87.717446 41.850321),60623-20210117
60612,12/17/2020,42,44,42,44,0.001,0,0,0,33735,POINT (-87.687011 41.88004),60612-20201217
60660,01/11/2021,72,1858,30,1624,0.036,42,234,0.005,44498,POINT (-87.666362 41.991062),60660-20210111
60827,12/29/2020,1,8,1,8,0,0,0,0,28483,POINT (-87.633087 41.650765),60827-20201229
60632,01/15/2021,53,998,49,857,0.01,4,141,0.002,89857,POINT (-87.711251 41.810038),60632-20210115
60640,01/12/2021,243,3254,133,2687,0.039,110,567,0.008,69363,POINT (-87.662232 41.971888),60640-20210112
60643,12/23/2020,30,301,30,301,0.006,0,0,0,48887,POINT (-87.662381 41.700445),60643-20201223
60647,01/15/2021,146,3675,127,2756,0.031,19,919,0.01,87633,POINT (-87.701101 41.921058),60647-20210115
60661,01/17/2021,6,1061,4,720,0.07,2,341,0.033,10354,POINT (-87.644283 41.882786),60661-20210117
60651,01/01/2021,0,234,0,234,0.004,0,0,0,63492,POINT (-87.741017 41.901964),60651-20210101
60628,01/11/2021,23,581,11,520,0.008,12,61,0.001,64254,POINT (-87.621537 41.694192),60628-20210111
60656,01/02/2021,18,300,18,300,0.011,0,0,0,28218,POINT (-87.817934 41.974566),60656-20210102
60666,12/26/2020,0,0,0,0,0,0,0,0,0,POINT (-87.896371 41.979511),60666-20201226
60624,12/30/2020,21,102,21,102,0.003,0,0,0,34892,POINT (-87.722735 41.879417),60624-20201230
60617,01/11/2021,65,750,29,634,0.008,36,116,0.001,83553,POINT (-87.556897 41.721257),60617-20210111
60622,01/03/2021,19,2141,18,2140,0.04,1,1,0,53294,POINT (-87.681818 41.902762),60622-20210103
60644,01/21/2021,82,1128,75,1010,0.022,7,118,0.003,46591,POINT (-87.756863 41.881113),60644-20210121
60651,01/05/2021,62,337,62,335,0.005,0,2,0,63492,POINT (-87.741017 41.901964),60651-20210105
60619,12/21/2020,18,67,18,67,0.001,0,0,0,61207,POINT (-87.60569 41.744737),60619-20201221
60617,12/31/2020,19,362,19,362,0.004,0,0,0,83553,POINT (-87.556897 41.721257),60617-20201231
60621,01/06/2021,14,219,11,214,0.008,3,5,0,28018,POINT (-87.638812 41.776931),60621-20210106
60609,12/18/2020,32,41,32,41,0.001,0,0,0,60939,POINT (-87.653382 41.812017),60609-20201218
60633,01/06/2021,6,74,5,73,0.006,1,1,0,12689,POINT (-87.556037 41.653147),60633-20210106
60827,01/13/2021,3,27,3,23,0.001,0,4,0,28483,POINT (-87.633087 41.650765),60827-20210113
60660,01/06/2021,78,877,67,861,0.019,11,16,0,44498,POINT (-87.666362 41.991062),60660-20210106
60628,12/16/2020,0,0,0,0,0,0,0,0,64254,POINT (-87.621537 41.694192),60628-20201216
60613,12/25/2020,0,802,0,802,0.016,0,0,0,50761,POINT (-87.661343 41.953742),60613-20201225
60642,12/17/2020,49,52,49,52,0.003,0,0,0,19716,POINT (-87.657821 41.899935),60642-20201217
60661,12/24/2020,11,351,11,351,0.034,0,0,0,10354,POINT (-87.644283 41.882786),60661-20201224
60608,12/26/2020,6,571,6,571,0.007,0,0,0,80059,POINT (-87.670366 41.849879),60608-20201226
60602,12/31/2020,0,44,0,44,0.038,0,0,0,1145,POINT (-87.628309 41.883136),60602-20201231
60644,12/18/2020,14,18,14,18,0,0,0,0,46591,POINT (-87.756863 41.881113),60644-20201218
60660,12/15/2020,0,0,0,0,0,0,0,0,44498,POINT (-87.666362 41.991062),60660-20201215
60605,12/30/2020,130,1503,130,1503,0.052,0,0,0,29060,POINT (-87.623449 41.867824),60605-20201230
60629,12/20/2020,20,122,20,122,0.001,0,0,0,110029,POINT (-87.711565 41.777061),60629-20201220
60610,01/11/2021,135,1827,31,1344,0.033,104,483,0.012,40548,POINT (-87.63581 41.90455),60610-20210111
60608,01/12/2021,184,2024,94,1606,0.02,90,418,0.005,80059,POINT (-87.670366 41.849879),60608-20210112
60624,12/16/2020,1,1,1,1,0,0,0,0,34892,POINT (-87.722735 41.879417),60624-20201216
60661,12/19/2020,61,197,61,197,0.019,0,0,0,10354,POINT (-87.644283 41.882786),60661-20201219
60827,12/30/2020,1,9,1,9,0,0,0,0,28483,POINT (-87.633087 41.650765),60827-20201230
Unknown,12/16/2020,0,0,0,0,0,0,0,0,0,,Unknown-20201216
60633,12/15/2020,0,0,0,0,0,0,0,0,12689,POINT (-87.556037 41.653147),60633-20201215
60622,12/19/2020,246,695,246,695,0.013,0,0,0,53294,POINT (-87.681818 41.902762),60622-20201219
60645,12/19/2020,49,133,49,133,0.003,0,0,0,47270,POINT (-87.695049 42.008927),60645-20201219
60610,12/22/2020,97,576,97,576,0.014,0,0,0,40548,POINT (-87.63581 41.90455),60610-20201222
60606,12/27/2020,1,92,1,92,0.028,0,0,0,3287,POINT (-87.63676 41.882634),60606-20201227
60646,12/20/2020,13,167,13,167,0.006,0,0,0,28569,POINT (-87.761826 41.993931),60646-20201220
60827,01/16/2021,2,35,2,30,0.001,0,5,0,28483,POINT (-87.633087 41.650765),60827-20210116
60666,01/18/2021,0,1,0,1,0,0,0,0,0,POINT (-87.896371 41.979511),60666-20210118
60632,12/29/2020,54,242,54,242,0.003,0,0,0,89857,POINT (-87.711251 41.810038),60632-20201229
60660,12/27/2020,0,346,0,346,0.008,0,0,0,44498,POINT (-87.666362 41.991062),60660-20201227
60639,12/28/2020,32,248,32,248,0.003,0,0,0,88204,POINT (-87.75531 41.920609),60639-20201228
60827,12/19/2020,0,4,0,4,0,0,0,0,28483,POINT (-87.633087 41.650765),60827-20201219
60606,12/22/2020,15,84,15,84,0.026,0,0,0,3287,POINT (-87.63676 41.882634),60606-20201222
60621,01/08/2021,17,251,13,239,0.009,4,12,0,28018,POINT (-87.638812 41.776931),60621-20210108
60633,12/19/2020,5,9,5,9,0.001,0,0,0,12689,POINT (-87.556037 41.653147),60633-20201219
60707,01/06/2021,10,154,9,152,0.004,1,2,0,43093,POINT (-87.808283 41.921777),60707-20210106
60642,12/26/2020,10,519,10,519,0.026,0,0,0,19716,POINT (-87.657821 41.899935),60642-20201226
60624,12/21/2020,11,35,11,35,0.001,0,0,0,34892,POINT (-87.722735 41.879417),60624-20201221
60605,01/04/2021,106,1702,88,1680,0.058,18,22,0.001,29060,POINT (-87.623449 41.867824),60605-20210104
60609,12/17/2020,9,9,9,9,0,0,0,0,60939,POINT (-87.653382 41.812017),60609-20201217
Unknown,12/21/2020,12,22,12,22,0,0,0,0,0,,Unknown-20201221
60645,12/29/2020,129,445,129,445,0.009,0,0,0,47270,POINT (-87.695049 42.008927),60645-20201229
60610,01/13/2021,102,2063,51,1450,0.036,51,613,0.015,40548,POINT (-87.63581 41.90455),60610-20210113
60618,01/04/2021,141,1635,132,1623,0.017,9,12,0,94907,POINT (-87.703343 41.946699),60618-20210104
60618,01/09/2021,198,2586,77,2126,0.022,121,460,0.005,94907,POINT (-87.703343 41.946699),60618-20210109
60602,01/01/2021,0,44,0,44,0.038,0,0,0,1145,POINT (-87.628309 41.883136),60602-20210101
60610,12/27/2020,0,657,0,657,0.016,0,0,0,40548,POINT (-87.63581 41.90455),60610-20201227
60640,12/30/2020,204,1098,204,1098,0.016,0,0,0,69363,POINT (-87.662232 41.971888),60640-20201230
60707,12/25/2020,0,75,0,75,0.002,0,0,0,43093,POINT (-87.808283 41.921777),60707-20201225
60646,12/19/2020,52,154,52,154,0.005,0,0,0,28569,POINT (-87.761826 41.993931),60646-20201219
60653,01/07/2021,41,527,27,500,0.015,14,27,0.001,33154,POINT (-87.611244 41.819261),60653-20210107
60613,12/26/2020,19,821,19,821,0.016,0,0,0,50761,POINT (-87.661343 41.953742),60613-20201226
60626,12/21/2020,61,228,61,228,0.005,0,0,0,50544,POINT (-87.669834 42.009469),60626-20201221
60651,12/29/2020,26,167,26,167,0.003,0,0,0,63492,POINT (-87.741017 41.901964),60651-20201229
60623,12/18/2020,26,38,26,38,0,0,0,0,81283,POINT (-87.717446 41.850321),60623-20201218
60644,01/02/2021,86,298,86,298,0.006,0,0,0,46591,POINT (-87.756863 41.881113),60644-20210102
60616,12/25/2020,0,644,0,644,0.012,0,0,0,54197,POINT (-87.629531 41.844869),60616-20201225
60630,01/04/2021,71,750,69,748,0.013,2,2,0,56433,POINT (-87.759611 41.971261),60630-20210104
60636,12/23/2020,7,27,7,27,0.001,0,0,0,30024,POINT (-87.668597 41.77599),60636-20201223
60633,01/20/2021,21,184,16,147,0.012,5,37,0.003,12689,POINT (-87.556037 41.653147),60633-20210120
60607,12/31/2020,61,1409,61,1409,0.048,0,0,0,29293,POINT (-87.652727 41.876104),60607-20201231
60626,12/26/2020,2,334,2,334,0.007,0,0,0,50544,POINT (-87.669834 42.009469),60626-20201226
60660,01/07/2021,651,1528,602,1463,0.033,49,65,0.001,44498,POINT (-87.666362 41.991062),60660-20210107
60637,01/17/2021,16,1698,0,1273,0.027,16,425,0.009,47300,POINT (-87.604053 41.780991),60637-20210117
60646,01/16/2021,33,1271,30,968,0.034,3,303,0.011,28569,POINT (-87.761826 41.993931),60646-20210116
60649,12/22/2020,17,78,17,78,0.002,0,0,0,46633,POINT (-87.571522 41.762202),60649-20201222
60651,01/16/2021,27,725,24,623,0.01,3,102,0.002,63492,POINT (-87.741017 41.901964),60651-20210116
60602,12/17/2020,1,1,1,1,0.001,0,0,0,1145,POINT (-87.628309 41.883136),60602-20201217
60621,01/01/2021,0,179,0,179,0.006,0,0,0,28018,POINT (-87.638812 41.776931),60621-20210101
60656,01/05/2021,25,358,25,358,0.013,0,0,0,28218,POINT (-87.817934 41.974566),60656-20210105
60657,12/25/2020,0,1439,0,1439,0.02,0,0,0,70958,POINT (-87.658216 41.939715),60657-20201225
60637,01/02/2021,7,626,7,626,0.013,0,0,0,47300,POINT (-87.604053 41.780991),60637-20210102
60707,12/20/2020,4,29,4,29,0.001,0,0,0,43093,POINT (-87.808283 41.921777),60707-20201220
60614,12/29/2020,188,1609,188,1609,0.022,0,0,0,71954,POINT (-87.652064 41.922605),60614-20201229
60639,01/02/2021,22,399,22,399,0.005,0,0,0,88204,POINT (-87.75531 41.920609),60639-20210102
60643,12/26/2020,1,312,1,312,0.006,0,0,0,48887,POINT (-87.662381 41.700445),60643-20201226
60642,12/15/2020,0,0,0,0,0,0,0,0,19716,POINT (-87.657821 41.899935),60642-20201215
60636,01/14/2021,12,222,10,198,0.007,2,24,0.001,30024,POINT (-87.668597 41.77599),60636-20210114
60621,12/22/2020,4,28,4,28,0.001,0,0,0,28018,POINT (-87.638812 41.776931),60621-20201222
60623,12/28/2020,93,250,93,250,0.003,0,0,0,81283,POINT (-87.717446 41.850321),60623-20201228
60606,01/18/2021,7,284,2,189,0.057,5,95,0.029,3287,POINT (-87.63676 41.882634),60606-20210118
60647,12/29/2020,118,1155,118,1155,0.013,0,0,0,87633,POINT (-87.701101 41.921058),60647-20201229
60652,12/24/2020,9,154,9,154,0.004,0,0,0,43447,POINT (-87.714238 41.745398),60652-20201224
60640,12/15/2020,0,0,0,0,0,0,0,0,69363,POINT (-87.662232 41.971888),60640-20201215
60636,01/07/2021,15,140,12,135,0.004,3,5,0,30024,POINT (-87.668597 41.77599),60636-20210107
60618,12/25/2020,0,914,0,914,0.01,0,0,0,94907,POINT (-87.703343 41.946699),60618-20201225
60619,12/22/2020,19,86,19,86,0.001,0,0,0,61207,POINT (-87.60569 41.744737),60619-20201222
60605,12/25/2020,0,1205,0,1205,0.041,0,0,0,29060,POINT (-87.623449 41.867824),60605-20201225
60625,12/20/2020,7,301,7,301,0.004,0,0,0,79444,POINT (-87.701816 41.971155),60625-20201220
60656,12/16/2020,1,1,1,1,0,0,0,0,28218,POINT (-87.817934 41.974566),60656-20201216
60623,01/08/2021,63,731,43,695,0.009,20,36,0,81283,POINT (-87.717446 41.850321),60623-20210108
60632,01/14/2021,69,945,59,808,0.009,10,137,0.002,89857,POINT (-87.711251 41.810038),60632-20210114
60644,01/17/2021,6,942,5,873,0.019,1,69,0.001,46591,POINT (-87.756863 41.881113),60644-20210117
60655,12/25/2020,0,372,0,372,0.013,0,0,0,28569,POINT (-87.701434 41.696456),60655-20201225
60661,12/20/2020,17,214,17,214,0.021,0,0,0,10354,POINT (-87.644283 41.882786),60661-20201220
60647,01/11/2021,185,2605,54,1950,0.022,131,655,0.007,87633,POINT (-87.701101 41.921058),60647-20210111
60620,01/05/2021,37,341,33,332,0.005,4,9,0,67711,POINT (-87.651656 41.740873),60620-20210105
Unknown,01/22/2021,42,662,40,577,0,2,85,0,0,,Unknown-20210122
60619,12/17/2020,7,7,7,7,0,0,0,0,61207,POINT (-87.60569 41.744737),60619-20201217
60628,12/20/2020,6,44,6,44,0.001,0,0,0,64254,POINT (-87.621537 41.694192),60628-20201220
60606,12/17/2020,7,7,7,7,0.002,0,0,0,3287,POINT (-87.63676 41.882634),60606-20201217
60617,12/27/2020,0,202,0,202,0.002,0,0,0,83553,POINT (-87.556897 41.721257),60617-20201227
60632,01/04/2021,48,469,47,468,0.005,1,1,0,89857,POINT (-87.711251 41.810038),60632-20210104
Unknown,01/12/2021,36,193,28,172,0,8,21,0,0,,Unknown-20210112
60624,01/01/2021,0,118,0,118,0.003,0,0,0,34892,POINT (-87.722735 41.879417),60624-20210101
60631,12/17/2020,20,23,20,23,0.001,0,0,0,29529,POINT (-87.813371 41.995019),60631-20201217
60637,12/16/2020,2,2,2,2,0,0,0,0,47300,POINT (-87.604053 41.780991),60637-20201216
60616,01/04/2021,74,1021,65,1010,0.019,9,11,0,54197,POINT (-87.629531 41.844869),60616-20210104
60639,01/17/2021,8,1360,6,1155,0.013,2,205,0.002,88204,POINT (-87.75531 41.920609),60639-20210117
60605,01/09/2021,177,2573,30,1939,0.067,147,634,0.022,29060,POINT (-87.623449 41.867824),60605-20210109
60629,01/07/2021,74,776,45,738,0.007,29,38,0,110029,POINT (-87.711565 41.777061),60629-20210107
60827,01/03/2021,0,9,0,9,0,0,0,0,28483,POINT (-87.633087 41.650765),60827-20210103
60608,01/08/2021,187,1467,88,1298,0.016,99,169,0.002,80059,POINT (-87.670366 41.849879),60608-20210108
60642,01/16/2021,39,1627,31,1118,0.057,8,509,0.026,19716,POINT (-87.657821 41.899935),60642-20210116
60608,12/22/2020,114,456,114,456,0.006,0,0,0,80059,POINT (-87.670366 41.849879),60608-20201222
60644,01/16/2021,20,936,17,868,0.019,3,68,0.001,46591,POINT (-87.756863 41.881113),60644-20210116
60656,12/21/2020,44,161,44,161,0.006,0,0,0,28218,POINT (-87.817934 41.974566),60656-20201221
60608,01/13/2021,160,2184,90,1696,0.021,70,488,0.006,80059,POINT (-87.670366 41.849879),60608-20210113
Unknown,01/05/2021,13,106,13,106,0,0,0,0,0,,Unknown-20210105
60633,01/03/2021,1,54,1,54,0.004,0,0,0,12689,POINT (-87.556037 41.653147),60633-20210103
60645,12/15/2020,0,0,0,0,0,0,0,0,47270,POINT (-87.695049 42.008927),60645-20201215
60628,01/04/2021,131,371,131,370,0.006,0,1,0,64254,POINT (-87.621537 41.694192),60628-20210104
60827,01/20/2021,3,42,2,36,0.001,1,6,0,28483,POINT (-87.633087 41.650765),60827-20210120
60616,12/30/2020,92,879,92,879,0.016,0,0,0,54197,POINT (-87.629531 41.844869),60616-20201230
60666,01/24/2021,0,2,0,2,0,0,0,0,0,POINT (-87.896371 41.979511),60666-20210124
60652,12/29/2020,53,307,53,307,0.007,0,0,0,43447,POINT (-87.714238 41.745398),60652-20201229
Unknown,01/17/2021,1,376,1,336,0,0,40,0,0,,Unknown-20210117
60642,12/30/2020,68,666,68,666,0.034,0,0,0,19716,POINT (-87.657821 41.899935),60642-20201230
60632,12/25/2020,0,154,0,154,0.002,0,0,0,89857,POINT (-87.711251 41.810038),60632-20201225
60827,12/23/2020,0,6,0,6,0,0,0,0,28483,POINT (-87.633087 41.650765),60827-20201223
60618,12/31/2020,80,1408,80,1408,0.015,0,0,0,94907,POINT (-87.703343 41.946699),60618-20201231
60608,01/19/2021,138,2694,74,2066,0.026,64,628,0.008,80059,POINT (-87.670366 41.849879),60608-20210119
60653,12/29/2020,150,341,150,341,0.01,0,0,0,33154,POINT (-87.611244 41.819261),60653-20201229
60609,01/01/2021,0,335,0,335,0.005,0,0,0,60939,POINT (-87.653382 41.812017),60609-20210101
60640,01/04/2021,198,1488,191,1481,0.021,7,7,0,69363,POINT (-87.662232 41.971888),60640-20210104
60660,12/23/2020,43,330,43,330,0.007,0,0,0,44498,POINT (-87.666362 41.991062),60660-20201223
60620,01/16/2021,21,891,18,755,0.011,3,136,0.002,67711,POINT (-87.651656 41.740873),60620-20210116
60623,01/12/2021,107,930,83,835,0.01,24,95,0.001,81283,POINT (-87.717446 41.850321),60623-20210112
60666,01/07/2021,0,0,0,0,0,0,0,0,0,POINT (-87.896371 41.979511),60666-20210107
60653,01/11/2021,34,705,13,601,0.018,21,104,0.003,33154,POINT (-87.611244 41.819261),60653-20210111
60605,12/17/2020,123,134,123,134,0.005,0,0,0,29060,POINT (-87.623449 41.867824),60605-20201217
60633,12/17/2020,2,2,2,2,0,0,0,0,12689,POINT (-87.556037 41.653147),60633-20201217
60607,12/26/2020,13,1008,13,1008,0.034,0,0,0,29293,POINT (-87.652727 41.876104),60607-20201226
60628,12/30/2020,37,215,37,215,0.003,0,0,0,64254,POINT (-87.621537 41.694192),60628-20201230
60657,01/04/2021,184,2336,175,2326,0.033,9,10,0,70958,POINT (-87.658216 41.939715),60657-20210104
60655,12/30/2020,59,496,59,496,0.017,0,0,0,28569,POINT (-87.701434 41.696456),60655-20201230
60617,01/13/2021,66,903,40,731,0.009,26,172,0.002,83553,POINT (-87.556897 41.721257),60617-20210113
60617,12/17/2020,24,25,24,25,0,0,0,0,83553,POINT (-87.556897 41.721257),60617-20201217
60657,12/28/2020,119,1609,119,1609,0.023,0,0,0,70958,POINT (-87.658216 41.939715),60657-20201228
60632,12/20/2020,6,53,6,53,0.001,0,0,0,89857,POINT (-87.711251 41.810038),60632-20201220
60661,01/10/2021,16,803,2,601,0.058,14,202,0.02,10354,POINT (-87.644283 41.882786),60661-20210110
60661,01/04/2021,34,512,29,507,0.049,5,5,0,10354,POINT (-87.644283 41.882786),60661-20210104
60606,01/13/2021,8,255,3,168,0.051,5,87,0.026,3287,POINT (-87.63676 41.882634),60606-20210113
60666,01/06/2021,0,0,0,0,0,0,0,0,0,POINT (-87.896371 41.979511),60666-20210106
60641,12/16/2020,18,18,18,18,0,0,0,0,69880,POINT (-87.746791 41.946682),60641-20201216
60621,01/13/2021,14,297,10,269,0.01,4,28,0.001,28018,POINT (-87.638812 41.776931),60621-20210113
60630,12/22/2020,33,364,33,364,0.006,0,0,0,56433,POINT (-87.759611 41.971261),60630-20201222
60643,01/02/2021,12,468,12,468,0.01,0,0,0,48887,POINT (-87.662381 41.700445),60643-20210102
60638,01/03/2021,9,575,9,575,0.01,0,0,0,58669,POINT (-87.771902 41.787032),60638-20210103
60633,01/08/2021,7,96,6,85,0.007,1,11,0.001,12689,POINT (-87.556037 41.653147),60633-20210108
60646,12/15/2020,0,0,0,0,0,0,0,0,28569,POINT (-87.761826 41.993931),60646-20201215
60656,12/24/2020,2,193,2,193,0.007,0,0,0,28218,POINT (-87.817934 41.974566),60656-20201224
60610,01/06/2021,67,1181,55,1152,0.028,12,29,0.001,40548,POINT (-87.63581 41.90455),60610-20210106
60649,01/11/2021,82,690,69,629,0.013,13,61,0.001,46633,POINT (-87.571522 41.762202),60649-20210111
60620,01/11/2021,26,669,10,582,0.009,16,87,0.001,67711,POINT (-87.651656 41.740873),60620-20210111
60623,12/24/2020,8,153,8,153,0.002,0,0,0,81283,POINT (-87.717446 41.850321),60623-20201224
60609,12/26/2020,2,181,2,181,0.003,0,0,0,60939,POINT (-87.653382 41.812017),60609-20201226
60633,01/18/2021,10,145,8,118,0.009,2,27,0.002,12689,POINT (-87.556037 41.653147),60633-20210118
60645,01/13/2021,99,1623,64,1375,0.029,35,248,0.005,47270,POINT (-87.695049 42.008927),60645-20210113
60645,01/15/2021,70,1767,66,1504,0.032,4,263,0.006,47270,POINT (-87.695049 42.008927),60645-20210115
60646,01/12/2021,55,966,26,721,0.025,29,245,0.009,28569,POINT (-87.761826 41.993931),60646-20210112
60624,12/25/2020,0,58,0,58,0.002,0,0,0,34892,POINT (-87.722735 41.879417),60624-20201225
60646,12/28/2020,18,332,18,332,0.012,0,0,0,28569,POINT (-87.761826 41.993931),60646-20201228
60646,12/26/2020,8,314,8,314,0.011,0,0,0,28569,POINT (-87.761826 41.993931),60646-20201226
60629,12/22/2020,47,214,47,214,0.002,0,0,0,110029,POINT (-87.711565 41.777061),60629-20201222
60649,12/28/2020,21,140,21,140,0.003,0,0,0,46633,POINT (-87.571522 41.762202),60649-20201228
60611,12/16/2020,14,14,14,14,0,0,0,0,33224,POINT (-87.620291 41.894734),60611-20201216
60644,12/27/2020,0,85,0,85,0.002,0,0,0,46591,POINT (-87.756863 41.881113),60644-20201227
60622,12/21/2020,264,1012,264,1012,0.019,0,0,0,53294,POINT (-87.681818 41.902762),60622-20201221
60614,12/25/2020,0,1281,0,1281,0.018,0,0,0,71954,POINT (-87.652064 41.922605),60614-20201225
60609,12/21/2020,31,103,31,103,0.002,0,0,0,60939,POINT (-87.653382 41.812017),60609-20201221
60625,01/04/2021,135,1300,131,1296,0.016,4,4,0,79444,POINT (-87.701816 41.971155),60625-20210104
60637,01/06/2021,106,934,90,891,0.019,16,43,0.001,47300,POINT (-87.604053 41.780991),60637-20210106
60640,12/25/2020,0,695,0,695,0.01,0,0,0,69363,POINT (-87.662232 41.971888),60640-20201225
60606,01/08/2021,30,189,7,153,0.047,23,36,0.011,3287,POINT (-87.63676 41.882634),60606-20210108
60632,01/07/2021,58,603,41,578,0.006,17,25,0,89857,POINT (-87.711251 41.810038),60632-20210107
60619,01/08/2021,57,479,34,440,0.007,23,39,0.001,61207,POINT (-87.60569 41.744737),60619-20210108
60660,01/03/2021,27,631,27,631,0.014,0,0,0,44498,POINT (-87.666362 41.991062),60660-20210103
60620,12/27/2020,0,134,0,134,0.002,0,0,0,67711,POINT (-87.651656 41.740873),60620-20201227
60657,12/18/2020,352,493,352,493,0.007,0,0,0,70958,POINT (-87.658216 41.939715),60657-20201218
60629,12/17/2020,17,19,17,19,0,0,0,0,110029,POINT (-87.711565 41.777061),60629-20201217
60628,12/25/2020,0,111,0,111,0.002,0,0,0,64254,POINT (-87.621537 41.694192),60628-20201225
60628,12/15/2020,0,0,0,0,0,0,0,0,64254,POINT (-87.621537 41.694192),60628-20201215
60610,01/03/2021,9,943,8,942,0.023,1,1,0,40548,POINT (-87.63581 41.90455),60610-20210103
60649,12/15/2020,0,0,0,0,0,0,0,0,46633,POINT (-87.571522 41.762202),60649-20201215
60617,01/08/2021,68,647,41,585,0.007,27,62,0.001,83553,POINT (-87.556897 41.721257),60617-20210108
60645,12/22/2020,37,233,37,233,0.005,0,0,0,47270,POINT (-87.695049 42.008927),60645-20201222
60644,12/30/2020,32,204,32,204,0.004,0,0,0,46591,POINT (-87.756863 41.881113),60644-20201230
60637,12/27/2020,0,363,0,363,0.008,0,0,0,47300,POINT (-87.604053 41.780991),60637-20201227
60644,12/15/2020,0,0,0,0,0,0,0,0,46591,POINT (-87.756863 41.881113),60644-20201215
60639,12/16/2020,3,3,3,3,0,0,0,0,88204,POINT (-87.75531 41.920609),60639-20201216
60629,01/09/2021,60,925,31,823,0.007,29,102,0.001,110029,POINT (-87.711565 41.777061),60629-20210109
60622,12/26/2020,16,1374,16,1374,0.026,0,0,0,53294,POINT (-87.681818 41.902762),60622-20201226
60827,01/24/2021,0,48,0,42,0.001,0,6,0,28483,POINT (-87.633087 41.650765),60827-20210124
60606,01/01/2021,0,123,0,123,0.037,0,0,0,3287,POINT (-87.63676 41.882634),60606-20210101
60613,12/15/2020,0,0,0,0,0,0,0,0,50761,POINT (-87.661343 41.953742),60613-20201215
60622,01/05/2021,136,2380,128,2358,0.044,8,22,0,53294,POINT (-87.681818 41.902762),60622-20210105
60661,12/16/2020,7,7,7,7,0.001,0,0,0,10354,POINT (-87.644283 41.882786),60661-20201216
60625,12/24/2020,19,623,19,623,0.008,0,0,0,79444,POINT (-87.701816 41.971155),60625-20201224
60620,01/01/2021,0,256,0,256,0.004,0,0,0,67711,POINT (-87.651656 41.740873),60620-20210101
60641,12/18/2020,93,144,93,144,0.002,0,0,0,69880,POINT (-87.746791 41.946682),60641-20201218
60651,01/11/2021,33,512,20,453,0.007,13,59,0.001,63492,POINT (-87.741017 41.901964),60651-20210111
60638,12/19/2020,48,143,48,143,0.002,0,0,0,58669,POINT (-87.771902 41.787032),60638-20201219
60612,12/30/2020,97,764,97,764,0.023,0,0,0,33735,POINT (-87.687011 41.88004),60612-20201230
60666,01/29/2021,3,9,3,9,0,0,0,0,0,POINT (-87.896371 41.979511),60666-20210129
60651,12/24/2020,6,109,6,109,0.002,0,0,0,63492,POINT (-87.741017 41.901964),60651-20201224
60628,01/09/2021,20,553,16,507,0.008,4,46,0.001,64254,POINT (-87.621537 41.694192),60628-20210109
60827,01/07/2021,2,15,2,15,0.001,0,0,0,28483,POINT (-87.633087 41.650765),60827-20210107
60621,12/29/2020,12,106,12,106,0.004,0,0,0,28018,POINT (-87.638812 41.776931),60621-20201229
60639,12/21/2020,42,131,42,131,0.001,0,0,0,88204,POINT (-87.75531 41.920609),60639-20201221
60608,12/18/2020,118,153,118,153,0.002,0,0,0,80059,POINT (-87.670366 41.849879),60608-20201218
Unknown,12/24/2020,3,37,3,37,0,0,0,0,0,,Unknown-20201224
60605,12/21/2020,175,812,175,812,0.028,0,0,0,29060,POINT (-87.623449 41.867824),60605-20201221
60620,12/21/2020,13,81,13,81,0.001,0,0,0,67711,POINT (-87.651656 41.740873),60620-20201221
60609,01/05/2021,37,411,34,408,0.007,3,3,0,60939,POINT (-87.653382 41.812017),60609-20210105
60639,01/12/2021,110,1069,76,910,0.01,34,159,0.002,88204,POINT (-87.75531 41.920609),60639-20210112
60622,01/02/2021,36,2122,36,2122,0.04,0,0,0,53294,POINT (-87.681818 41.902762),60622-20210102
60647,01/02/2021,45,1384,45,1384,0.016,0,0,0,87633,POINT (-87.701101 41.921058),60647-20210102
60620,01/12/2021,62,731,39,621,0.009,23,110,0.002,67711,POINT (-87.651656 41.740873),60620-20210112
60636,01/03/2021,1,87,1,87,0.003,0,0,0,30024,POINT (-87.668597 41.77599),60636-20210103
60607,12/21/2020,142,683,142,683,0.023,0,0,0,29293,POINT (-87.652727 41.876104),60607-20201221
60666,12/23/2020,0,0,0,0,0,0,0,0,0,POINT (-87.896371 41.979511),60666-20201223
60617,01/03/2021,7,374,7,374,0.004,0,0,0,83553,POINT (-87.556897 41.721257),60617-20210103
60612,12/25/2020,0,522,0,522,0.015,0,0,0,33735,POINT (-87.687011 41.88004),60612-20201225
60637,12/20/2020,21,143,21,143,0.003,0,0,0,47300,POINT (-87.604053 41.780991),60637-20201220
60608,01/04/2021,97,1031,91,1025,0.013,6,6,0,80059,POINT (-87.670366 41.849879),60608-20210104
60617,12/22/2020,41,157,41,157,0.002,0,0,0,83553,POINT (-87.556897 41.721257),60617-20201222
60602,12/24/2020,2,30,2,30,0.026,0,0,0,1145,POINT (-87.628309 41.883136),60602-20201224
60606,01/12/2021,19,247,4,165,0.05,15,82,0.025,3287,POINT (-87.63676 41.882634),60606-20210112
60632,01/01/2021,1,403,1,403,0.004,0,0,0,89857,POINT (-87.711251 41.810038),60632-20210101
60653,12/25/2020,0,168,0,168,0.005,0,0,0,33154,POINT (-87.611244 41.819261),60653-20201225
60623,12/25/2020,0,153,0,153,0.002,0,0,0,81283,POINT (-87.717446 41.850321),60623-20201225
60666,01/11/2021,0,0,0,0,0,0,0,0,0,POINT (-87.896371 41.979511),60666-20210111
60618,01/17/2021,54,3733,32,2811,0.03,22,922,0.01,94907,POINT (-87.703343 41.946699),60618-20210117
60642,01/07/2021,90,940,25,853,0.043,65,87,0.004,19716,POINT (-87.657821 41.899935),60642-20210107
60609,01/10/2021,14,693,3,621,0.01,11,72,0.001,60939,POINT (-87.653382 41.812017),60609-20210110
60628,12/26/2020,1,112,1,112,0.002,0,0,0,64254,POINT (-87.621537 41.694192),60628-20201226
60602,01/08/2021,10,73,3,63,0.055,7,10,0.009,1145,POINT (-87.628309 41.883136),60602-20210108
60610,01/10/2021,27,1692,8,1313,0.032,19,379,0.009,40548,POINT (-87.63581 41.90455),60610-20210110
60621,01/16/2021,8,318,6,287,0.01,2,31,0.001,28018,POINT (-87.638812 41.776931),60621-20210116
60649,01/07/2021,38,433,23,413,0.009,15,20,0,46633,POINT (-87.571522 41.762202),60649-20210107
60606,01/23/2021,13,369,11,247,0.075,2,122,0.037,3287,POINT (-87.63676 41.882634),60606-20210123
60623,01/16/2021,26,1127,22,986,0.012,4,141,0.002,81283,POINT (-87.717446 41.850321),60623-20210116
60629,01/08/2021,89,865,54,792,0.007,35,73,0.001,110029,POINT (-87.711565 41.777061),60629-20210108
60646,01/24/2021,28,2021,26,1607,0.056,2,414,0.014,28569,POINT (-87.761826 41.993931),60646-20210124
60655,12/26/2020,5,377,5,377,0.013,0,0,0,28569,POINT (-87.701434 41.696456),60655-20201226
60661,01/14/2021,33,1006,22,674,0.065,11,332,0.032,10354,POINT (-87.644283 41.882786),60661-20210114
60630,12/26/2020,9,433,9,433,0.008,0,0,0,56433,POINT (-87.759611 41.971261),60630-20201226
60666,01/02/2021,0,0,0,0,0,0,0,0,0,POINT (-87.896371 41.979511),60666-20210102
60618,12/16/2020,3,3,3,3,0,0,0,0,94907,POINT (-87.703343 41.946699),60618-20201216
60621,01/09/2021,6,257,2,241,0.009,4,16,0.001,28018,POINT (-87.638812 41.776931),60621-20210109
60649,12/27/2020,0,119,0,119,0.003,0,0,0,46633,POINT (-87.571522 41.762202),60649-20201227
60653,12/20/2020,12,70,12,70,0.002,0,0,0,33154,POINT (-87.611244 41.819261),60653-20201220
60629,12/29/2020,81,400,81,400,0.004,0,0,0,110029,POINT (-87.711565 41.777061),60629-20201229
60643,12/18/2020,58,85,58,85,0.002,0,0,0,48887,POINT (-87.662381 41.700445),60643-20201218
60629,01/03/2021,20,559,20,559,0.005,0,0,0,110029,POINT (-87.711565 41.777061),60629-20210103
60636,12/15/2020,0,0,0,0,0,0,0,0,30024,POINT (-87.668597 41.77599),60636-20201215
60656,12/28/2020,17,213,17,213,0.008,0,0,0,28218,POINT (-87.817934 41.974566),60656-20201228
60660,01/15/2021,73,2232,68,1903,0.043,5,329,0.007,44498,POINT (-87.666362 41.991062),60660-20210115
60638,12/25/2020,0,322,0,322,0.005,0,0,0,58669,POINT (-87.771902 41.787032),60638-20201225
60633,01/28/2021,26,343,21,276,0.022,5,67,0.005,12689,POINT (-87.556037 41.653147),60633-20210128
60642,01/22/2021,74,2013,64,1357,0.069,10,656,0.033,19716,POINT (-87.657821 41.899935),60642-20210122
60624,12/29/2020,16,81,16,81,0.002,0,0,0,34892,POINT (-87.722735 41.879417),60624-20201229
60645,01/06/2021,86,1026,79,1016,0.021,7,10,0,47270,POINT (-87.695049 42.008927),60645-20210106
60644,12/23/2020,22,78,22,78,0.002,0,0,0,46591,POINT (-87.756863 41.881113),60644-20201223
60655,12/16/2020,0,0,0,0,0,0,0,0,28569,POINT (-87.701434 41.696456),60655-20201216
60620,12/31/2020,12,256,12,256,0.004,0,0,0,67711,POINT (-87.651656 41.740873),60620-20201231
60624,12/22/2020,14,49,14,49,0.001,0,0,0,34892,POINT (-87.722735 41.879417),60624-20201222
60657,12/31/2020,59,2054,59,2054,0.029,0,0,0,70958,POINT (-87.658216 41.939715),60657-20201231
60633,12/27/2020,0,26,0,26,0.002,0,0,0,12689,POINT (-87.556037 41.653147),60633-20201227
60827,01/12/2021,4,24,2,20,0.001,2,4,0,28483,POINT (-87.633087 41.650765),60827-20210112
60653,01/06/2021,30,486,21,473,0.014,9,13,0,33154,POINT (-87.611244 41.819261),60653-20210106
60619,01/04/2021,33,313,31,311,0.005,2,2,0,61207,POINT (-87.60569 41.744737),60619-20210104
60649,01/01/2021,0,306,0,306,0.007,0,0,0,46633,POINT (-87.571522 41.762202),60649-20210101
60623,12/20/2020,6,56,6,56,0.001,0,0,0,81283,POINT (-87.717446 41.850321),60623-20201220
60614,12/21/2020,272,950,272,950,0.013,0,0,0,71954,POINT (-87.652064 41.922605),60614-20201221
60612,01/06/2021,51,994,42,982,0.029,9,12,0,33735,POINT (-87.687011 41.88004),60612-20210106
60827,01/02/2021,0,9,0,9,0,0,0,0,28483,POINT (-87.633087 41.650765),60827-20210102
60622,12/29/2020,259,1695,259,1695,0.032,0,0,0,53294,POINT (-87.681818 41.902762),60622-20201229
60625,12/28/2020,60,699,60,699,0.009,0,0,0,79444,POINT (-87.701816 41.971155),60625-20201228
60625,12/31/2020,85,985,85,985,0.012,0,0,0,79444,POINT (-87.701816 41.971155),60625-20201231
60637,01/10/2021,29,1211,4,1000,0.021,25,211,0.004,47300,POINT (-87.604053 41.780991),60637-20210110
60628,01/16/2021,17,766,15,663,0.01,2,103,0.002,64254,POINT (-87.621537 41.694192),60628-20210116
60644,01/09/2021,14,642,10,621,0.013,4,21,0,46591,POINT (-87.756863 41.881113),60644-20210109
60651,01/21/2021,129,1041,119,856,0.013,10,185,0.003,63492,POINT (-87.741017 41.901964),60651-20210121
60653,12/15/2020,0,0,0,0,0,0,0,0,33154,POINT (-87.611244 41.819261),60653-20201215
60614,12/16/2020,3,4,3,4,0,0,0,0,71954,POINT (-87.652064 41.922605),60614-20201216
60610,12/30/2020,97,874,97,874,0.022,0,0,0,40548,POINT (-87.63581 41.90455),60610-20201230
60623,12/15/2020,0,0,0,0,0,0,0,0,81283,POINT (-87.717446 41.850321),60623-20201215
60630,12/16/2020,4,4,4,4,0,0,0,0,56433,POINT (-87.759611 41.971261),60630-20201216
60649,12/19/2020,6,46,6,46,0.001,0,0,0,46633,POINT (-87.571522 41.762202),60649-20201219
60630,12/21/2020,102,331,102,331,0.006,0,0,0,56433,POINT (-87.759611 41.971261),60630-20201221
60645,12/18/2020,63,84,63,84,0.002,0,0,0,47270,POINT (-87.695049 42.008927),60645-20201218
60707,12/15/2020,0,0,0,0,0,0,0,0,43093,POINT (-87.808283 41.921777),60707-20201215
60613,12/19/2020,121,386,121,386,0.008,0,0,0,50761,POINT (-87.661343 41.953742),60613-20201219
60632,12/17/2020,12,15,12,15,0,0,0,0,89857,POINT (-87.711251 41.810038),60632-20201217
60666,12/16/2020,0,0,0,0,0,0,0,0,0,POINT (-87.896371 41.979511),60666-20201216
60651,12/20/2020,4,48,4,48,0.001,0,0,0,63492,POINT (-87.741017 41.901964),60651-20201220
60629,01/13/2021,104,1219,77,984,0.009,27,235,0.002,110029,POINT (-87.711565 41.777061),60629-20210113
60640,01/16/2021,81,3939,67,3252,0.047,14,687,0.01,69363,POINT (-87.662232 41.971888),60640-20210116
Unknown,01/25/2021,12,700,8,611,0,4,89,0,0,,Unknown-20210125
60653,12/30/2020,48,389,48,389,0.012,0,0,0,33154,POINT (-87.611244 41.819261),60653-20201230
60621,12/25/2020,0,33,0,33,0.001,0,0,0,28018,POINT (-87.638812 41.776931),60621-20201225
60621,12/15/2020,0,0,0,0,0,0,0,0,28018,POINT (-87.638812 41.776931),60621-20201215
60609,12/22/2020,34,137,34,137,0.002,0,0,0,60939,POINT (-87.653382 41.812017),60609-20201222
60618,12/26/2020,25,939,25,939,0.01,0,0,0,94907,POINT (-87.703343 41.946699),60618-20201226
60642,12/21/2020,71,360,71,360,0.018,0,0,0,19716,POINT (-87.657821 41.899935),60642-20201221
60614,01/05/2021,179,2159,170,2138,0.03,9,21,0,71954,POINT (-87.652064 41.922605),60614-20210105
60655,12/31/2020,30,526,30,526,0.018,0,0,0,28569,POINT (-87.701434 41.696456),60655-20201231
Unknown,12/28/2020,2,42,2,42,0,0,0,0,0,,Unknown-20201228
60602,01/13/2021,3,96,2,68,0.059,1,28,0.024,1145,POINT (-87.628309 41.883136),60602-20210113
60620,12/17/2020,15,15,15,15,0,0,0,0,67711,POINT (-87.651656 41.740873),60620-20201217
60639,12/17/2020,7,10,7,10,0,0,0,0,88204,POINT (-87.75531 41.920609),60639-20201217
60661,12/28/2020,14,373,14,373,0.036,0,0,0,10354,POINT (-87.644283 41.882786),60661-20201228
60639,01/08/2021,90,749,60,684,0.008,30,65,0.001,88204,POINT (-87.75531 41.920609),60639-20210108
60666,12/27/2020,0,0,0,0,0,0,0,0,0,POINT (-87.896371 41.979511),60666-20201227
60660,12/31/2020,32,588,32,588,0.013,0,0,0,44498,POINT (-87.666362 41.991062),60660-20201231
60643,12/17/2020,26,27,26,27,0.001,0,0,0,48887,POINT (-87.662381 41.700445),60643-20201217
60636,12/30/2020,19,73,19,73,0.002,0,0,0,30024,POINT (-87.668597 41.77599),60636-20201230
60636,01/04/2021,11,98,11,98,0.003,0,0,0,30024,POINT (-87.668597 41.77599),60636-20210104
60605,12/31/2020,40,1543,40,1543,0.053,0,0,0,29060,POINT (-87.623449 41.867824),60605-20201231
60637,01/13/2021,78,1397,50,1080,0.023,28,317,0.007,47300,POINT (-87.604053 41.780991),60637-20210113
60644,01/24/2021,2,1240,2,1117,0.024,0,123,0.003,46591,POINT (-87.756863 41.881113),60644-20210124
60607,01/05/2021,86,1692,74,1670,0.057,12,22,0.001,29293,POINT (-87.652727 41.876104),60607-20210105
60660,12/21/2020,59,242,59,242,0.005,0,0,0,44498,POINT (-87.666362 41.991062),60660-20201221
60610,12/18/2020,160,224,160,224,0.006,0,0,0,40548,POINT (-87.63581 41.90455),60610-20201218
60612,12/20/2020,11,220,11,220,0.007,0,0,0,33735,POINT (-87.687011 41.88004),60612-20201220
60637,12/24/2020,35,359,35,359,0.008,0,0,0,47300,POINT (-87.604053 41.780991),60637-20201224
60621,01/20/2021,16,362,8,315,0.011,8,47,0.002,28018,POINT (-87.638812 41.776931),60621-20210120
60633,01/11/2021,7,105,2,89,0.007,5,16,0.001,12689,POINT (-87.556037 41.653147),60633-20210111
60651,01/04/2021,27,275,25,273,0.004,2,2,0,63492,POINT (-87.741017 41.901964),60651-20210104
60647,01/06/2021,103,1703,75,1660,0.019,28,43,0,87633,POINT (-87.701101 41.921058),60647-20210106
60639,12/22/2020,43,174,43,174,0.002,0,0,0,88204,POINT (-87.75531 41.920609),60639-20201222
60602,01/12/2021,9,93,2,66,0.058,7,27,0.024,1145,POINT (-87.628309 41.883136),60602-20210112
60606,01/27/2021,14,429,11,296,0.09,3,133,0.04,3287,POINT (-87.63676 41.882634),60606-20210127
60602,12/20/2020,2,15,2,15,0.013,0,0,0,1145,POINT (-87.628309 41.883136),60602-20201220
60707,01/10/2021,7,207,2,182,0.004,5,25,0.001,43093,POINT (-87.808283 41.921777),60707-20210110
60624,12/17/2020,8,9,8,9,0,0,0,0,34892,POINT (-87.722735 41.879417),60624-20201217
Unknown,12/17/2020,4,4,4,4,0,0,0,0,0,,Unknown-20201217
60646,12/18/2020,89,102,89,102,0.004,0,0,0,28569,POINT (-87.761826 41.993931),60646-20201218
60638,12/29/2020,73,430,73,430,0.007,0,0,0,58669,POINT (-87.771902 41.787032),60638-20201229
60660,12/26/2020,5,346,5,346,0.008,0,0,0,44498,POINT (-87.666362 41.991062),60660-20201226
60607,12/25/2020,0,995,0,995,0.034,0,0,0,29293,POINT (-87.652727 41.876104),60607-20201225
60646,12/23/2020,49,301,49,301,0.011,0,0,0,28569,POINT (-87.761826 41.993931),60646-20201223
60616,12/20/2020,36,338,36,338,0.006,0,0,0,54197,POINT (-87.629531 41.844869),60616-20201220
60618,01/05/2021,151,1786,145,1768,0.019,6,18,0,94907,POINT (-87.703343 41.946699),60618-20210105
60610,12/23/2020,45,621,45,621,0.015,0,0,0,40548,POINT (-87.63581 41.90455),60610-20201223
60606,12/26/2020,1,91,1,91,0.028,0,0,0,3287,POINT (-87.63676 41.882634),60606-20201226
60666,01/17/2021,0,1,0,1,0,0,0,0,0,POINT (-87.896371 41.979511),60666-20210117
60620,01/10/2021,9,643,2,572,0.008,7,71,0.001,67711,POINT (-87.651656 41.740873),60620-20210110
60620,01/19/2021,66,997,50,835,0.012,16,162,0.002,67711,POINT (-87.651656 41.740873),60620-20210119
60632,12/28/2020,28,188,28,188,0.002,0,0,0,89857,POINT (-87.711251 41.810038),60632-20201228
60613,12/22/2020,119,678,119,678,0.013,0,0,0,50761,POINT (-87.661343 41.953742),60613-20201222
60643,12/22/2020,57,271,57,271,0.006,0,0,0,48887,POINT (-87.662381 41.700445),60643-20201222
60623,01/04/2021,49,459,48,458,0.006,1,1,0,81283,POINT (-87.717446 41.850321),60623-20210104
60636,12/27/2020,0,31,0,31,0.001,0,0,0,30024,POINT (-87.668597 41.77599),60636-20201227
60623,01/21/2021,128,1488,112,1254,0.015,16,234,0.003,81283,POINT (-87.717446 41.850321),60623-20210121
60621,12/19/2020,6,15,6,15,0.001,0,0,0,28018,POINT (-87.638812 41.776931),60621-20201219
60827,12/28/2020,0,7,0,7,0,0,0,0,28483,POINT (-87.633087 41.650765),60827-20201228
60651,01/02/2021,12,246,12,246,0.004,0,0,0,63492,POINT (-87.741017 41.901964),60651-20210102
60630,12/31/2020,44,649,44,649,0.012,0,0,0,56433,POINT (-87.759611 41.971261),60630-20201231
60621,01/05/2021,17,205,15,203,0.007,2,2,0,28018,POINT (-87.638812 41.776931),60621-20210105
60652,12/17/2020,12,13,12,13,0,0,0,0,43447,POINT (-87.714238 41.745398),60652-20201217
60707,12/30/2020,16,114,16,114,0.003,0,0,0,43093,POINT (-87.808283 41.921777),60707-20201230
60652,12/23/2020,30,145,30,145,0.003,0,0,0,43447,POINT (-87.714238 41.745398),60652-20201223
60631,12/30/2020,48,454,48,454,0.015,0,0,0,29529,POINT (-87.813371 41.995019),60631-20201230
60646,01/05/2021,62,587,62,587,0.021,0,0,0,28569,POINT (-87.761826 41.993931),60646-20210105
60610,01/14/2021,86,2149,65,1515,0.037,21,634,0.016,40548,POINT (-87.63581 41.90455),60610-20210114
60618,01/10/2021,26,2612,8,2134,0.022,18,478,0.005,94907,POINT (-87.703343 41.946699),60618-20210110
60633,12/31/2020,3,48,3,48,0.004,0,0,0,12689,POINT (-87.556037 41.653147),60633-20201231
60827,01/29/2021,5,72,4,61,0.002,1,11,0,28483,POINT (-87.633087 41.650765),60827-20210129
60623,01/01/2021,0,390,0,390,0.005,0,0,0,81283,POINT (-87.717446 41.850321),60623-20210101
60656,01/01/2021,0,282,0,282,0.01,0,0,0,28218,POINT (-87.817934 41.974566),60656-20210101
60619,12/18/2020,27,34,27,34,0.001,0,0,0,61207,POINT (-87.60569 41.744737),60619-20201218
60657,12/27/2020,1,1490,1,1490,0.021,0,0,0,70958,POINT (-87.658216 41.939715),60657-20201227
60623,01/19/2021,73,1245,42,1058,0.013,31,187,0.002,81283,POINT (-87.717446 41.850321),60623-20210119
60640,12/21/2020,140,466,140,466,0.007,0,0,0,69363,POINT (-87.662232 41.971888),60640-20201221
60633,02/01/2021,12,420,12,348,0.027,0,72,0.006,12689,POINT (-87.556037 41.653147),60633-20210201
60644,01/05/2021,207,542,207,542,0.012,0,0,0,46591,POINT (-87.756863 41.881113),60644-20210105
60646,01/19/2021,72,1410,59,1073,0.038,13,337,0.012,28569,POINT (-87.761826 41.993931),60646-20210119
60613,12/27/2020,0,821,0,821,0.016,0,0,0,50761,POINT (-87.661343 41.953742),60613-20201227
60614,01/02/2021,53,1847,53,1847,0.026,0,0,0,71954,POINT (-87.652064 41.922605),60614-20210102
60636,01/16/2021,7,240,6,214,0.007,1,26,0.001,30024,POINT (-87.668597 41.77599),60636-20210116
60707,12/24/2020,4,75,4,75,0.002,0,0,0,43093,POINT (-87.808283 41.921777),60707-20201224
60618,12/21/2020,179,628,179,628,0.007,0,0,0,94907,POINT (-87.703343 41.946699),60618-20201221
60608,12/27/2020,0,571,0,571,0.007,0,0,0,80059,POINT (-87.670366 41.849879),60608-20201227
60642,12/16/2020,3,3,3,3,0,0,0,0,19716,POINT (-87.657821 41.899935),60642-20201216
60619,12/30/2020,43,244,43,244,0.004,0,0,0,61207,POINT (-87.60569 41.744737),60619-20201230
60636,01/11/2021,7,177,6,163,0.005,1,14,0,30024,POINT (-87.668597 41.77599),60636-20210111
60631,12/25/2020,0,340,0,340,0.012,0,0,0,29529,POINT (-87.813371 41.995019),60631-20201225
60625,12/16/2020,4,4,4,4,0,0,0,0,79444,POINT (-87.701816 41.971155),60625-20201216
60612,01/02/2021,7,804,7,804,0.024,0,0,0,33735,POINT (-87.687011 41.88004),60612-20210102
60637,12/29/2020,73,450,73,450,0.01,0,0,0,47300,POINT (-87.604053 41.780991),60637-20201229
60652,12/28/2020,98,254,98,254,0.006,0,0,0,43447,POINT (-87.714238 41.745398),60652-20201228
60608,01/09/2021,155,1622,93,1391,0.017,62,231,0.003,80059,POINT (-87.670366 41.849879),60608-20210109
60605,12/29/2020,103,1373,103,1373,0.047,0,0,0,29060,POINT (-87.623449 41.867824),60605-20201229
60605,01/13/2021,160,3245,62,2117,0.073,98,1128,0.039,29060,POINT (-87.623449 41.867824),60605-20210113
60610,12/28/2020,52,709,52,709,0.017,0,0,0,40548,POINT (-87.63581 41.90455),60610-20201228
60637,12/19/2020,41,122,41,122,0.003,0,0,0,47300,POINT (-87.604053 41.780991),60637-20201219
60608,01/14/2021,121,2305,97,1793,0.022,24,512,0.006,80059,POINT (-87.670366 41.849879),60608-20210114
60640,01/11/2021,285,3011,162,2554,0.037,123,457,0.007,69363,POINT (-87.662232 41.971888),60640-20210111
60707,12/19/2020,8,25,8,25,0.001,0,0,0,43093,POINT (-87.808283 41.921777),60707-20201219
60641,12/24/2020,22,428,22,428,0.006,0,0,0,69880,POINT (-87.746791 41.946682),60641-20201224
60655,12/21/2020,74,296,74,296,0.01,0,0,0,28569,POINT (-87.701434 41.696456),60655-20201221
60622,12/18/2020,311,449,311,449,0.008,0,0,0,53294,POINT (-87.681818 41.902762),60622-20201218
60647,12/18/2020,241,336,241,336,0.004,0,0,0,87633,POINT (-87.701101 41.921058),60647-20201218
60642,01/17/2021,11,1638,6,1124,0.057,5,514,0.026,19716,POINT (-87.657821 41.899935),60642-20210117
60645,01/10/2021,15,1308,8,1165,0.025,7,143,0.003,47270,POINT (-87.695049 42.008927),60645-20210110
60624,01/03/2021,1,125,1,125,0.004,0,0,0,34892,POINT (-87.722735 41.879417),60624-20210103
60616,01/08/2021,170,1612,39,1343,0.025,131,269,0.005,54197,POINT (-87.629531 41.844869),60616-20210108
60647,01/09/2021,171,2374,50,1873,0.021,121,501,0.006,87633,POINT (-87.701101 41.921058),60647-20210109
60651,01/25/2021,76,1289,53,1074,0.017,23,215,0.003,63492,POINT (-87.741017 41.901964),60651-20210125
Unknown,01/16/2021,33,375,29,335,0,4,40,0,0,,Unknown-20210116
Unknown,01/18/2021,3,379,2,338,0,1,41,0,0,,Unknown-20210118
Unknown,01/29/2021,34,915,31,789,0,3,126,0,0,,Unknown-20210129
60655,01/04/2021,18,681,17,680,0.024,1,1,0,28569,POINT (-87.701434 41.696456),60655-20210104
60617,12/21/2020,34,116,34,116,0.001,0,0,0,83553,POINT (-87.556897 41.721257),60617-20201221
60656,12/17/2020,9,10,9,10,0,0,0,0,28218,POINT (-87.817934 41.974566),60656-20201217
60642,01/12/2021,116,1410,48,986,0.05,68,424,0.022,19716,POINT (-87.657821 41.899935),60642-20210112
60626,12/16/2020,1,1,1,1,0,0,0,0,50544,POINT (-87.669834 42.009469),60626-20201216
60640,12/31/2020,58,1156,58,1156,0.017,0,0,0,69363,POINT (-87.662232 41.971888),60640-20201231
60646,01/09/2021,52,838,10,677,0.024,42,161,0.006,28569,POINT (-87.761826 41.993931),60646-20210109
60651,01/10/2021,9,479,6,433,0.007,3,46,0.001,63492,POINT (-87.741017 41.901964),60651-20210110
Unknown,01/01/2021,0,86,0,86,0,0,0,0,0,,Unknown-20210101
60666,01/28/2021,1,6,1,6,0,0,0,0,0,POINT (-87.896371 41.979511),60666-20210128
60628,01/08/2021,65,533,41,491,0.008,24,42,0.001,64254,POINT (-87.621537 41.694192),60628-20210108
60633,01/15/2021,7,131,7,108,0.009,0,23,0.002,12689,POINT (-87.556037 41.653147),60633-20210115
60647,12/25/2020,0,966,0,966,0.011,0,0,0,87633,POINT (-87.701101 41.921058),60647-20201225
60612,12/16/2020,2,2,2,2,0,0,0,0,33735,POINT (-87.687011 41.88004),60612-20201216
60623,12/19/2020,12,50,12,50,0.001,0,0,0,81283,POINT (-87.717446 41.850321),60623-20201219
60616,01/03/2021,20,947,18,945,0.017,2,2,0,54197,POINT (-87.629531 41.844869),60616-20210103
60618,12/19/2020,149,425,149,425,0.004,0,0,0,94907,POINT (-87.703343 41.946699),60618-20201219
60619,01/09/2021,24,503,17,457,0.007,7,46,0.001,61207,POINT (-87.60569 41.744737),60619-20210109
60608,01/07/2021,110,1280,63,1210,0.015,47,70,0.001,80059,POINT (-87.670366 41.849879),60608-20210107
60827,01/04/2021,2,11,2,11,0,0,0,0,28483,POINT (-87.633087 41.650765),60827-20210104
60620,12/22/2020,25,106,25,106,0.002,0,0,0,67711,POINT (-87.651656 41.740873),60620-20201222
60608,12/17/2020,35,35,35,35,0,0,0,0,80059,POINT (-87.670366 41.849879),60608-20201217
60666,12/24/2020,0,0,0,0,0,0,0,0,0,POINT (-87.896371 41.979511),60666-20201224
Unknown,01/06/2021,13,119,13,119,0,0,0,0,0,,Unknown-20210106
60633,12/30/2020,8,45,8,45,0.004,0,0,0,12689,POINT (-87.556037 41.653147),60633-20201230
60637,01/18/2021,181,1879,149,1422,0.03,32,457,0.01,47300,POINT (-87.604053 41.780991),60637-20210118
60640,01/13/2021,300,3554,229,2916,0.042,71,638,0.009,69363,POINT (-87.662232 41.971888),60640-20210113
Unknown,01/28/2021,80,881,74,758,0,6,123,0,0,,Unknown-20210128
60657,12/22/2020,205,1245,205,1245,0.018,0,0,0,70958,POINT (-87.658216 41.939715),60657-20201222
60827,01/15/2021,3,33,3,28,0.001,0,5,0,28483,POINT (-87.633087 41.650765),60827-20210115
60633,01/04/2021,5,59,5,59,0.005,0,0,0,12689,POINT (-87.556037 41.653147),60633-20210104
60637,12/17/2020,24,26,24,26,0.001,0,0,0,47300,POINT (-87.604053 41.780991),60637-20201217
60642,12/31/2020,27,693,27,693,0.035,0,0,0,19716,POINT (-87.657821 41.899935),60642-20201231
60655,01/02/2021,125,651,125,651,0.023,0,0,0,28569,POINT (-87.701434 41.696456),60655-20210102
60617,01/09/2021,32,679,19,604,0.007,13,75,0.001,83553,POINT (-87.556897 41.721257),60617-20210109
60614,12/26/2020,37,1318,37,1318,0.018,0,0,0,71954,POINT (-87.652064 41.922605),60614-20201226
60661,12/21/2020,56,270,56,270,0.026,0,0,0,10354,POINT (-87.644283 41.882786),60661-20201221
60827,01/25/2021,2,50,1,43,0.002,1,7,0,28483,POINT (-87.633087 41.650765),60827-20210125
60619,12/23/2020,25,111,25,111,0.002,0,0,0,61207,POINT (-87.60569 41.744737),60619-20201223
60629,12/18/2020,50,69,50,69,0.001,0,0,0,110029,POINT (-87.711565 41.777061),60629-20201218
60602,01/02/2021,0,44,0,44,0.038,0,0,0,1145,POINT (-87.628309 41.883136),60602-20210102
60636,12/16/2020,0,0,0,0,0,0,0,0,30024,POINT (-87.668597 41.77599),60636-20201216
60605,12/24/2020,42,1205,42,1205,0.041,0,0,0,29060,POINT (-87.623449 41.867824),60605-20201224
60625,12/21/2020,129,430,129,430,0.005,0,0,0,79444,POINT (-87.701816 41.971155),60625-20201221
60661,01/01/2021,0,461,0,461,0.045,0,0,0,10354,POINT (-87.644283 41.882786),60661-20210101
60605,01/15/2021,81,3419,58,2235,0.077,23,1184,0.041,29060,POINT (-87.623449 41.867824),60605-20210115
60645,12/26/2020,5,285,5,285,0.006,0,0,0,47270,POINT (-87.695049 42.008927),60645-20201226
60629,01/12/2021,103,1115,55,907,0.008,48,208,0.002,110029,POINT (-87.711565 41.777061),60629-20210112
60649,01/10/2021,5,608,3,560,0.012,2,48,0.001,46633,POINT (-87.571522 41.762202),60649-20210110
60637,01/20/2021,187,2275,132,1732,0.037,55,543,0.011,47300,POINT (-87.604053 41.780991),60637-20210120
60644,01/18/2021,18,960,11,884,0.019,7,76,0.002,46591,POINT (-87.756863 41.881113),60644-20210118
60661,01/11/2021,57,860,7,608,0.059,50,252,0.024,10354,POINT (-87.644283 41.882786),60661-20210111
Unknown,01/11/2021,7,157,3,144,0,4,13,0,0,,Unknown-20210111
60827,12/24/2020,1,7,1,7,0,0,0,0,28483,POINT (-87.633087 41.650765),60827-20201224
60608,12/28/2020,35,606,35,606,0.008,0,0,0,80059,POINT (-87.670366 41.849879),60608-20201228
60631,12/18/2020,85,108,85,108,0.004,0,0,0,29529,POINT (-87.813371 41.995019),60631-20201218
Unknown,12/27/2020,0,40,0,40,0,0,0,0,0,,Unknown-20201227
60646,01/04/2021,52,525,52,525,0.018,0,0,0,28569,POINT (-87.761826 41.993931),60646-20210104
60642,01/13/2021,85,1495,35,1021,0.052,50,474,0.024,19716,POINT (-87.657821 41.899935),60642-20210113
60636,12/22/2020,4,20,4,20,0.001,0,0,0,30024,POINT (-87.668597 41.77599),60636-20201222
60606,12/28/2020,5,97,5,97,0.03,0,0,0,3287,POINT (-87.63676 41.882634),60606-20201228
60666,01/25/2021,1,3,1,3,0,0,0,0,0,POINT (-87.896371 41.979511),60666-20210125
60633,01/19/2021,18,163,13,131,0.01,5,32,0.003,12689,POINT (-87.556037 41.653147),60633-20210119
60649,12/23/2020,26,104,26,104,0.002,0,0,0,46633,POINT (-87.571522 41.762202),60649-20201223
60628,01/05/2021,24,395,24,394,0.006,0,1,0,64254,POINT (-87.621537 41.694192),60628-20210105
60626,12/27/2020,0,334,0,334,0.007,0,0,0,50544,POINT (-87.669834 42.009469),60626-20201227
60612,12/26/2020,4,526,4,526,0.016,0,0,0,33735,POINT (-87.687011 41.88004),60612-20201226
60609,12/31/2020,29,335,29,335,0.005,0,0,0,60939,POINT (-87.653382 41.812017),60609-20201231
60622,12/22/2020,198,1210,198,1210,0.023,0,0,0,53294,POINT (-87.681818 41.902762),60622-20201222
60625,12/23/2020,107,604,107,604,0.008,0,0,0,79444,POINT (-87.701816 41.971155),60625-20201223
60614,12/28/2020,101,1421,101,1421,0.02,0,0,0,71954,POINT (-87.652064 41.922605),60614-20201228
60639,12/30/2020,57,337,57,337,0.004,0,0,0,88204,POINT (-87.75531 41.920609),60639-20201230
60625,01/05/2021,126,1426,123,1419,0.018,3,7,0,79444,POINT (-87.701816 41.971155),60625-20210105
60636,01/17/2021,2,242,2,216,0.007,0,26,0.001,30024,POINT (-87.668597 41.77599),60636-20210117
60621,12/23/2020,4,32,4,32,0.001,0,0,0,28018,POINT (-87.638812 41.776931),60621-20201223
60645,12/31/2020,44,641,44,641,0.014,0,0,0,47270,POINT (-87.695049 42.008927),60645-20201231
60653,01/08/2021,57,584,29,529,0.016,28,55,0.002,33154,POINT (-87.611244 41.819261),60653-20210108
Unknown,02/02/2021,41,992,20,835,0,21,157,0,0,,Unknown-20210202
60660,12/24/2020,11,341,11,341,0.008,0,0,0,44498,POINT (-87.666362 41.991062),60660-20201224
60660,12/18/2020,93,123,93,123,0.003,0,0,0,44498,POINT (-87.666362 41.991062),60660-20201218
60643,12/20/2020,26,153,26,153,0.003,0,0,0,48887,POINT (-87.662381 41.700445),60643-20201220
60606,01/19/2021,9,293,5,194,0.059,4,99,0.03,3287,POINT (-87.63676 41.882634),60606-20210119
60637,12/30/2020,122,572,122,572,0.012,0,0,0,47300,POINT (-87.604053 41.780991),60637-20201230
60653,12/22/2020,32,133,32,133,0.004,0,0,0,33154,POINT (-87.611244 41.819261),60653-20201222
60618,01/03/2021,39,1494,36,1491,0.016,3,3,0,94907,POINT (-87.703343 41.946699),60618-20210103
60655,12/22/2020,46,342,46,342,0.012,0,0,0,28569,POINT (-87.701434 41.696456),60655-20201222
60616,12/19/2020,81,302,81,302,0.006,0,0,0,54197,POINT (-87.629531 41.844869),60616-20201219
60614,12/19/2020,177,630,177,630,0.009,0,0,0,71954,POINT (-87.652064 41.922605),60614-20201219
60630,12/29/2020,64,531,64,531,0.009,0,0,0,56433,POINT (-87.759611 41.971261),60630-20201229
60633,01/22/2021,27,228,21,183,0.014,6,45,0.004,12689,POINT (-87.556037 41.653147),60633-20210122
60653,01/12/2021,90,795,65,666,0.02,25,129,0.004,33154,POINT (-87.611244 41.819261),60653-20210112
60651,12/23/2020,20,103,20,103,0.002,0,0,0,63492,POINT (-87.741017 41.901964),60651-20201223
60649,01/03/2021,11,323,11,323,0.007,0,0,0,46633,POINT (-87.571522 41.762202),60649-20210103
60628,12/21/2020,20,64,20,64,0.001,0,0,0,64254,POINT (-87.621537 41.694192),60628-20201221
60607,12/15/2020,1,1,1,1,0,0,0,0,29293,POINT (-87.652727 41.876104),60607-20201215
60612,12/19/2020,52,209,52,209,0.006,0,0,0,33735,POINT (-87.687011 41.88004),60612-20201219
60651,12/26/2020,3,112,3,112,0.002,0,0,0,63492,POINT (-87.741017 41.901964),60651-20201226
60649,12/26/2020,1,119,1,119,0.003,0,0,0,46633,POINT (-87.571522 41.762202),60649-20201226
60624,12/24/2020,1,58,1,58,0.002,0,0,0,34892,POINT (-87.722735 41.879417),60624-20201224
60644,01/03/2021,7,305,7,305,0.007,0,0,0,46591,POINT (-87.756863 41.881113),60644-20210103
60618,12/15/2020,0,0,0,0,0,0,0,0,94907,POINT (-87.703343 41.946699),60618-20201215
60608,12/21/2020,98,342,98,342,0.004,0,0,0,80059,POINT (-87.670366 41.849879),60608-20201221
60602,12/28/2020,4,34,4,34,0.03,0,0,0,1145,POINT (-87.628309 41.883136),60602-20201228
60639,12/18/2020,40,50,40,50,0.001,0,0,0,88204,POINT (-87.75531 41.920609),60639-20201218
60629,12/23/2020,46,260,46,260,0.002,0,0,0,110029,POINT (-87.711565 41.777061),60629-20201223
60645,12/16/2020,5,5,5,5,0,0,0,0,47270,POINT (-87.695049 42.008927),60645-20201216
60605,01/08/2021,283,2396,56,1909,0.066,227,487,0.017,29060,POINT (-87.623449 41.867824),60605-20210108
60622,01/01/2021,2,2086,2,2086,0.039,0,0,0,53294,POINT (-87.681818 41.902762),60622-20210101
60632,01/08/2021,46,649,34,612,0.007,12,37,0,89857,POINT (-87.711251 41.810038),60632-20210108
60646,12/29/2020,47,379,47,379,0.013,0,0,0,28569,POINT (-87.761826 41.993931),60646-20201229
60656,01/08/2021,65,492,17,401,0.014,48,91,0.003,28218,POINT (-87.817934 41.974566),60656-20210108
60652,12/30/2020,54,361,54,361,0.008,0,0,0,43447,POINT (-87.714238 41.745398),60652-20201230
60660,01/08/2021,190,1718,101,1564,0.035,89,154,0.003,44498,POINT (-87.666362 41.991062),60660-20210108
60827,01/21/2021,3,45,3,39,0.001,0,6,0,28483,POINT (-87.633087 41.650765),60827-20210121
60640,01/17/2021,42,3981,34,3286,0.047,8,695,0.01,69363,POINT (-87.662232 41.971888),60640-20210117
60646,01/13/2021,178,1144,137,858,0.03,41,286,0.01,28569,POINT (-87.761826 41.993931),60646-20210113
60651,01/17/2021,4,729,4,627,0.01,0,102,0.002,63492,POINT (-87.741017 41.901964),60651-20210117
60638,12/21/2020,54,224,54,224,0.004,0,0,0,58669,POINT (-87.771902 41.787032),60638-20201221
60620,12/26/2020,2,134,2,134,0.002,0,0,0,67711,POINT (-87.651656 41.740873),60620-20201226
60608,01/03/2021,10,934,10,934,0.012,0,0,0,80059,POINT (-87.670366 41.849879),60608-20210103
60707,12/21/2020,13,42,13,42,0.001,0,0,0,43093,POINT (-87.808283 41.921777),60707-20201221
60647,12/22/2020,151,829,151,829,0.009,0,0,0,87633,POINT (-87.701101 41.921058),60647-20201222
60827,12/20/2020,0,4,0,4,0,0,0,0,28483,POINT (-87.633087 41.650765),60827-20201220
60633,12/18/2020,2,4,2,4,0,0,0,0,12689,POINT (-87.556037 41.653147),60633-20201218
60607,12/27/2020,0,1008,0,1008,0.034,0,0,0,29293,POINT (-87.652727 41.876104),60607-20201227
60609,12/16/2020,0,0,0,0,0,0,0,0,60939,POINT (-87.653382 41.812017),60609-20201216
60605,01/05/2021,105,1807,75,1755,0.06,30,52,0.002,29060,POINT (-87.623449 41.867824),60605-20210105
Unknown,12/22/2020,4,26,4,26,0,0,0,0,0,,Unknown-20201222
60636,01/06/2021,15,125,14,123,0.004,1,2,0,30024,POINT (-87.668597 41.77599),60636-20210106
60657,01/03/2021,30,2152,29,2151,0.03,1,1,0,70958,POINT (-87.658216 41.939715),60657-20210103
60608,01/18/2021,93,2556,57,1992,0.025,36,564,0.007,80059,POINT (-87.670366 41.849879),60608-20210118
60644,12/31/2020,8,212,8,212,0.005,0,0,0,46591,POINT (-87.756863 41.881113),60644-20201231
60637,01/05/2021,48,828,32,801,0.017,16,27,0.001,47300,POINT (-87.604053 41.780991),60637-20210105
60651,01/12/2021,58,570,42,495,0.008,16,75,0.001,63492,POINT (-87.741017 41.901964),60651-20210112
Unknown,01/23/2021,25,687,25,602,0,0,85,0,0,,Unknown-20210123
60606,01/02/2021,6,129,6,129,0.039,0,0,0,3287,POINT (-87.63676 41.882634),60606-20210102
60610,12/24/2020,21,642,21,642,0.016,0,0,0,40548,POINT (-87.63581 41.90455),60610-20201224
60638,12/16/2020,0,0,0,0,0,0,0,0,58669,POINT (-87.771902 41.787032),60638-20201216
60666,12/21/2020,0,0,0,0,0,0,0,0,0,POINT (-87.896371 41.979511),60666-20201221
60661,12/17/2020,41,48,41,48,0.005,0,0,0,10354,POINT (-87.644283 41.882786),60661-20201217
60612,12/31/2020,33,797,33,797,0.024,0,0,0,33735,POINT (-87.687011 41.88004),60612-20201231
60606,12/18/2020,29,36,29,36,0.011,0,0,0,3287,POINT (-87.63676 41.882634),60606-20201218
60666,01/30/2021,0,9,0,9,0,0,0,0,0,POINT (-87.896371 41.979511),60666-20210130
60632,01/05/2021,44,513,43,511,0.006,1,2,0,89857,POINT (-87.711251 41.810038),60632-20210105
60666,01/05/2021,0,0,0,0,0,0,0,0,0,POINT (-87.896371 41.979511),60666-20210105
60628,01/10/2021,5,558,2,509,0.008,3,49,0.001,64254,POINT (-87.621537 41.694192),60628-20210110
60626,12/22/2020,43,271,43,271,0.005,0,0,0,50544,POINT (-87.669834 42.009469),60626-20201222
60617,12/28/2020,40,242,40,242,0.003,0,0,0,83553,POINT (-87.556897 41.721257),60617-20201228
60643,12/30/2020,66,439,66,439,0.009,0,0,0,48887,POINT (-87.662381 41.700445),60643-20201230
60609,01/11/2021,51,744,17,638,0.01,34,106,0.002,60939,POINT (-87.653382 41.812017),60609-20210111
60621,01/14/2021,9,306,8,277,0.01,1,29,0.001,28018,POINT (-87.638812 41.776931),60621-20210114
60623,01/09/2021,35,766,27,722,0.009,8,44,0.001,81283,POINT (-87.717446 41.850321),60623-20210109
60644,01/13/2021,156,858,142,806,0.017,14,52,0.001,46591,POINT (-87.756863 41.881113),60644-20210113
60661,01/08/2021,91,721,22,592,0.057,69,129,0.012,10354,POINT (-87.644283 41.882786),60661-20210108
60616,12/26/2020,12,656,12,656,0.012,0,0,0,54197,POINT (-87.629531 41.844869),60616-20201226
60645,01/14/2021,74,1697,63,1438,0.03,11,259,0.005,47270,POINT (-87.695049 42.008927),60645-20210114
60639,01/11/2021,79,959,51,834,0.009,28,125,0.001,88204,POINT (-87.75531 41.920609),60639-20210111
60630,01/05/2021,154,904,152,900,0.016,2,4,0,56433,POINT (-87.759611 41.971261),60630-20210105
60642,01/09/2021,103,1189,27,909,0.046,76,280,0.014,19716,POINT (-87.657821 41.899935),60642-20210109
60661,12/27/2020,0,359,0,359,0.035,0,0,0,10354,POINT (-87.644283 41.882786),60661-20201227
60645,01/16/2021,32,1799,28,1532,0.032,4,267,0.006,47270,POINT (-87.695049 42.008927),60645-20210116
60647,01/01/2021,0,1339,0,1339,0.015,0,0,0,87633,POINT (-87.701101 41.921058),60647-20210101
60660,01/14/2021,80,2159,66,1835,0.041,14,324,0.007,44498,POINT (-87.666362 41.991062),60660-20210114
60656,12/20/2020,12,117,12,117,0.004,0,0,0,28218,POINT (-87.817934 41.974566),60656-20201220
60656,12/25/2020,0,193,0,193,0.007,0,0,0,28218,POINT (-87.817934 41.974566),60656-20201225
60606,01/29/2021,24,474,20,335,0.102,4,139,0.042,3287,POINT (-87.63676 41.882634),60606-20210129
60617,12/23/2020,32,189,32,189,0.002,0,0,0,83553,POINT (-87.556897 41.721257),60617-20201223
60607,01/01/2021,1,1410,1,1410,0.048,0,0,0,29293,POINT (-87.652727 41.876104),60607-20210101
60632,12/22/2020,34,118,34,118,0.001,0,0,0,89857,POINT (-87.711251 41.810038),60632-20201222
60649,12/29/2020,131,271,131,271,0.006,0,0,0,46633,POINT (-87.571522 41.762202),60649-20201229
60656,01/09/2021,33,525,8,409,0.014,25,116,0.004,28218,POINT (-87.817934 41.974566),60656-20210109
60616,12/31/2020,35,914,35,914,0.017,0,0,0,54197,POINT (-87.629531 41.844869),60616-20201231
60602,12/18/2020,7,8,7,8,0.007,0,0,0,1145,POINT (-87.628309 41.883136),60602-20201218
60612,12/24/2020,35,522,35,522,0.015,0,0,0,33735,POINT (-87.687011 41.88004),60612-20201224
60644,12/26/2020,3,85,3,85,0.002,0,0,0,46591,POINT (-87.756863 41.881113),60644-20201226
60606,01/07/2021,9,159,5,146,0.044,4,13,0.004,3287,POINT (-87.63676 41.882634),60606-20210107
60633,01/14/2021,3,124,2,101,0.008,1,23,0.002,12689,POINT (-87.556037 41.653147),60633-20210114
60647,12/26/2020,13,979,13,979,0.011,0,0,0,87633,POINT (-87.701101 41.921058),60647-20201226
60609,01/17/2021,10,1053,4,867,0.014,6,186,0.003,60939,POINT (-87.653382 41.812017),60609-20210117
60636,01/15/2021,11,233,10,208,0.007,1,25,0.001,30024,POINT (-87.668597 41.77599),60636-20210115
60638,01/05/2021,47,666,44,659,0.011,3,7,0,58669,POINT (-87.771902 41.787032),60638-20210105
60640,12/24/2020,18,695,18,695,0.01,0,0,0,69363,POINT (-87.662232 41.971888),60640-20201224
60620,01/13/2021,63,794,50,671,0.01,13,123,0.002,67711,POINT (-87.651656 41.740873),60620-20210113
60623,12/27/2020,0,157,0,157,0.002,0,0,0,81283,POINT (-87.717446 41.850321),60623-20201227
60612,01/05/2021,49,943,47,940,0.028,2,3,0,33735,POINT (-87.687011 41.88004),60612-20210105
60660,12/22/2020,45,287,45,287,0.006,0,0,0,44498,POINT (-87.666362 41.991062),60660-20201222
60639,12/27/2020,0,216,0,216,0.002,0,0,0,88204,POINT (-87.75531 41.920609),60639-20201227
60614,12/15/2020,1,1,1,1,0,0,0,0,71954,POINT (-87.652064 41.922605),60614-20201215
60610,01/04/2021,49,992,42,984,0.024,7,8,0,40548,POINT (-87.63581 41.90455),60610-20210104
60605,12/16/2020,11,11,11,11,0,0,0,0,29060,POINT (-87.623449 41.867824),60605-20201216
60652,12/25/2020,0,154,0,154,0.004,0,0,0,43447,POINT (-87.714238 41.745398),60652-20201225
60707,01/07/2021,14,168,7,159,0.004,7,9,0,43093,POINT (-87.808283 41.921777),60707-20210107
60619,12/29/2020,48,201,48,201,0.003,0,0,0,61207,POINT (-87.60569 41.744737),60619-20201229
60666,01/08/2021,0,0,0,0,0,0,0,0,0,POINT (-87.896371 41.979511),60666-20210108
60618,12/30/2020,161,1328,161,1328,0.014,0,0,0,94907,POINT (-87.703343 41.946699),60618-20201230
60632,12/21/2020,31,84,31,84,0.001,0,0,0,89857,POINT (-87.711251 41.810038),60632-20201221
60630,12/25/2020,0,424,0,424,0.008,0,0,0,56433,POINT (-87.759611 41.971261),60630-20201225
60620,01/06/2021,138,479,134,466,0.007,4,13,0,67711,POINT (-87.651656 41.740873),60620-20210106
60647,12/17/2020,87,95,87,95,0.001,0,0,0,87633,POINT (-87.701101 41.921058),60647-20201217
60657,12/29/2020,171,1780,171,1780,0.025,0,0,0,70958,POINT (-87.658216 41.939715),60657-20201229
60618,01/16/2021,109,3679,93,2779,0.029,16,900,0.009,94907,POINT (-87.703343 41.946699),60618-20210116
60655,12/18/2020,90,131,90,131,0.005,0,0,0,28569,POINT (-87.701434 41.696456),60655-20201218
60622,12/27/2020,0,1374,0,1374,0.026,0,0,0,53294,POINT (-87.681818 41.902762),60622-20201227
60707,01/12/2021,26,250,17,206,0.005,9,44,0.001,43093,POINT (-87.808283 41.921777),60707-20210112
60628,01/15/2021,39,749,39,648,0.01,0,101,0.002,64254,POINT (-87.621537 41.694192),60628-20210115
60653,12/26/2020,0,168,0,168,0.005,0,0,0,33154,POINT (-87.611244 41.819261),60653-20201226
60827,01/08/2021,3,18,1,16,0.001,2,2,0,28483,POINT (-87.633087 41.650765),60827-20210108
60602,12/23/2020,4,28,4,28,0.024,0,0,0,1145,POINT (-87.628309 41.883136),60602-20201223
60606,01/14/2021,6,261,6,174,0.053,0,87,0.026,3287,POINT (-87.63676 41.882634),60606-20210114
60623,01/05/2021,34,493,34,492,0.006,0,1,0,81283,POINT (-87.717446 41.850321),60623-20210105
60649,01/13/2021,118,903,102,811,0.017,16,92,0.002,46633,POINT (-87.571522 41.762202),60649-20210113
60609,12/27/2020,0,181,0,181,0.003,0,0,0,60939,POINT (-87.653382 41.812017),60609-20201227
60623,01/11/2021,50,823,26,752,0.009,24,71,0.001,81283,POINT (-87.717446 41.850321),60623-20210111
60621,12/26/2020,1,34,1,34,0.001,0,0,0,28018,POINT (-87.638812 41.776931),60621-20201226
60641,12/17/2020,33,51,33,51,0.001,0,0,0,69880,POINT (-87.746791 41.946682),60641-20201217
60640,01/10/2021,32,2726,17,2392,0.034,15,334,0.005,69363,POINT (-87.662232 41.971888),60640-20210110
60707,12/26/2020,0,75,0,75,0.002,0,0,0,43093,POINT (-87.808283 41.921777),60707-20201226
60638,01/04/2021,44,619,40,615,0.01,4,4,0,58669,POINT (-87.771902 41.787032),60638-20210104
60647,01/12/2021,244,2849,133,2083,0.024,111,766,0.009,87633,POINT (-87.701101 41.921058),60647-20210112
60618,12/27/2020,0,939,0,939,0.01,0,0,0,94907,POINT (-87.703343 41.946699),60618-20201227
60610,01/05/2021,122,1114,113,1097,0.027,9,17,0,40548,POINT (-87.63581 41.90455),60610-20210105
60660,01/04/2021,91,722,87,718,0.016,4,4,0,44498,POINT (-87.666362 41.991062),60660-20210104
60602,01/14/2021,7,103,5,73,0.064,2,30,0.026,1145,POINT (-87.628309 41.883136),60602-20210114
60827,12/27/2020,0,7,0,7,0,0,0,0,28483,POINT (-87.633087 41.650765),60827-20201227
60651,12/30/2020,49,216,49,216,0.003,0,0,0,63492,POINT (-87.741017 41.901964),60651-20201230
60651,12/15/2020,0,0,0,0,0,0,0,0,63492,POINT (-87.741017 41.901964),60651-20201215
60652,12/16/2020,0,1,0,1,0,0,0,0,43447,POINT (-87.714238 41.745398),60652-20201216
60605,01/12/2021,227,3085,70,2055,0.071,157,1030,0.035,29060,POINT (-87.623449 41.867824),60605-20210112
60623,01/10/2021,7,773,4,726,0.009,3,47,0.001,81283,POINT (-87.717446 41.850321),60623-20210110
60646,12/27/2020,0,314,0,314,0.011,0,0,0,28569,POINT (-87.761826 41.993931),60646-20201227
60619,12/24/2020,10,121,10,121,0.002,0,0,0,61207,POINT (-87.60569 41.744737),60619-20201224
60633,01/27/2021,30,317,27,255,0.02,3,62,0.005,12689,POINT (-87.556037 41.653147),60633-20210127
60624,12/28/2020,6,65,6,65,0.002,0,0,0,34892,POINT (-87.722735 41.879417),60624-20201228
60644,01/23/2021,33,1238,31,1115,0.024,2,123,0.003,46591,POINT (-87.756863 41.881113),60644-20210123
60645,01/05/2021,117,940,116,937,0.02,1,3,0,47270,POINT (-87.695049 42.008927),60645-20210105
60643,12/16/2020,1,1,1,1,0,0,0,0,48887,POINT (-87.662381 41.700445),60643-20201216
60660,12/30/2020,116,556,116,556,0.012,0,0,0,44498,POINT (-87.666362 41.991062),60660-20201230
60655,12/15/2020,0,0,0,0,0,0,0,0,28569,POINT (-87.701434 41.696456),60655-20201215
60621,12/31/2020,2,179,2,179,0.006,0,0,0,28018,POINT (-87.638812 41.776931),60621-20201231
60656,01/04/2021,30,333,30,333,0.012,0,0,0,28218,POINT (-87.817934 41.974566),60656-20210104
60617,01/02/2021,5,367,5,367,0.004,0,0,0,83553,POINT (-87.556897 41.721257),60617-20210102
60609,12/20/2020,12,72,12,72,0.001,0,0,0,60939,POINT (-87.653382 41.812017),60609-20201220
60643,12/29/2020,43,373,43,373,0.008,0,0,0,48887,POINT (-87.662381 41.700445),60643-20201229
60651,01/03/2021,2,248,2,248,0.004,0,0,0,63492,POINT (-87.741017 41.901964),60651-20210103
60620,12/30/2020,53,244,53,244,0.004,0,0,0,67711,POINT (-87.651656 41.740873),60620-20201230
60612,12/23/2020,76,487,76,487,0.014,0,0,0,33735,POINT (-87.687011 41.88004),60612-20201223
60605,01/01/2021,2,1545,2,1545,0.053,0,0,0,29060,POINT (-87.623449 41.867824),60605-20210101
60622,12/28/2020,62,1436,62,1436,0.027,0,0,0,53294,POINT (-87.681818 41.902762),60622-20201228
60606,12/21/2020,17,69,17,69,0.021,0,0,0,3287,POINT (-87.63676 41.882634),60606-20201221
60827,02/02/2021,5,87,3,72,0.003,2,15,0.001,28483,POINT (-87.633087 41.650765),60827-20210202
60637,01/09/2021,78,1182,24,996,0.021,54,186,0.004,47300,POINT (-87.604053 41.780991),60637-20210109
60651,01/24/2021,7,1213,6,1021,0.016,1,192,0.003,63492,POINT (-87.741017 41.901964),60651-20210124
60620,12/15/2020,0,0,0,0,0,0,0,0,67711,POINT (-87.651656 41.740873),60620-20201215
60660,12/17/2020,28,30,28,30,0.001,0,0,0,44498,POINT (-87.666362 41.991062),60660-20201217
60642,01/06/2021,36,850,25,828,0.042,11,22,0.001,19716,POINT (-87.657821 41.899935),60642-20210106
60644,12/16/2020,0,0,0,0,0,0,0,0,46591,POINT (-87.756863 41.881113),60644-20201216
Unknown,12/18/2020,4,8,4,8,0,0,0,0,0,,Unknown-20201218
60636,01/10/2021,1,170,0,157,0.005,1,13,0,30024,POINT (-87.668597 41.77599),60636-20210110
60628,12/29/2020,35,178,35,178,0.003,0,0,0,64254,POINT (-87.621537 41.694192),60628-20201229
60827,01/01/2021,0,9,0,9,0,0,0,0,28483,POINT (-87.633087 41.650765),60827-20210101
60625,12/15/2020,0,0,0,0,0,0,0,0,79444,POINT (-87.701816 41.971155),60625-20201215
60649,12/18/2020,27,40,27,40,0.001,0,0,0,46633,POINT (-87.571522 41.762202),60649-20201218
60617,12/16/2020,1,1,1,1,0,0,0,0,83553,POINT (-87.556897 41.721257),60617-20201216
60622,12/17/2020,135,138,135,138,0.003,0,0,0,53294,POINT (-87.681818 41.902762),60622-20201217
60610,12/20/2020,24,346,24,346,0.009,0,0,0,40548,POINT (-87.63581 41.90455),60610-20201220
60645,12/21/2020,52,196,52,196,0.004,0,0,0,47270,POINT (-87.695049 42.008927),60645-20201221
60646,12/22/2020,30,252,30,252,0.009,0,0,0,28569,POINT (-87.761826 41.993931),60646-20201222
60608,01/15/2021,88,2393,80,1873,0.023,8,520,0.006,80059,POINT (-87.670366 41.849879),60608-20210115
60613,12/18/2020,210,265,210,265,0.005,0,0,0,50761,POINT (-87.661343 41.953742),60613-20201218
60620,01/18/2021,36,931,27,785,0.012,9,146,0.002,67711,POINT (-87.651656 41.740873),60620-20210118
60609,01/07/2021,52,596,36,571,0.009,16,25,0,60939,POINT (-87.653382 41.812017),60609-20210107
60610,01/15/2021,83,2232,72,1587,0.039,11,645,0.016,40548,POINT (-87.63581 41.90455),60610-20210115
60827,01/18/2021,1,36,1,31,0.001,0,5,0,28483,POINT (-87.633087 41.650765),60827-20210118
60618,01/06/2021,126,1912,108,1876,0.02,18,36,0,94907,POINT (-87.703343 41.946699),60618-20210106
60638,12/20/2020,27,170,27,170,0.003,0,0,0,58669,POINT (-87.771902 41.787032),60638-20201220
60643,01/03/2021,13,481,12,480,0.01,1,1,0,48887,POINT (-87.662381 41.700445),60643-20210103
60666,01/01/2021,0,0,0,0,0,0,0,0,0,POINT (-87.896371 41.979511),60666-20210101
60613,12/23/2020,87,765,87,765,0.015,0,0,0,50761,POINT (-87.661343 41.953742),60613-20201223
60632,12/27/2020,0,160,0,160,0.002,0,0,0,89857,POINT (-87.711251 41.810038),60632-20201227
60642,12/20/2020,24,289,24,289,0.015,0,0,0,19716,POINT (-87.657821 41.899935),60642-20201220
60629,12/28/2020,33,319,33,319,0.003,0,0,0,110029,POINT (-87.711565 41.777061),60629-20201228
60623,12/31/2020,37,390,37,390,0.005,0,0,0,81283,POINT (-87.717446 41.850321),60623-20201231
60621,01/10/2021,1,258,1,242,0.009,0,16,0.001,28018,POINT (-87.638812 41.776931),60621-20210110
60633,01/10/2021,1,98,1,87,0.007,0,11,0.001,12689,POINT (-87.556037 41.653147),60633-20210110
60643,12/19/2020,42,127,42,127,0.003,0,0,0,48887,POINT (-87.662381 41.700445),60643-20201219
60614,01/06/2021,108,2267,82,2220,0.031,26,47,0.001,71954,POINT (-87.652064 41.922605),60614-20210106
60632,01/17/2021,11,1061,6,908,0.01,5,153,0.002,89857,POINT (-87.711251 41.810038),60632-20210117
60646,01/23/2021,178,1993,169,1581,0.055,9,412,0.014,28569,POINT (-87.761826 41.993931),60646-20210123
Unknown,01/19/2021,65,444,51,389,0,14,55,0,0,,Unknown-20210119
60707,12/29/2020,17,98,17,98,0.002,0,0,0,43093,POINT (-87.808283 41.921777),60707-20201229
60661,12/31/2020,23,461,23,461,0.045,0,0,0,10354,POINT (-87.644283 41.882786),60661-20201231
60638,12/24/2020,11,322,11,322,0.005,0,0,0,58669,POINT (-87.771902 41.787032),60638-20201224
60827,12/17/2020,0,0,0,0,0,0,0,0,28483,POINT (-87.633087 41.650765),60827-20201217
60656,12/29/2020,30,243,30,243,0.009,0,0,0,28218,POINT (-87.817934 41.974566),60656-20201229
60626,12/19/2020,58,159,58,159,0.003,0,0,0,50544,POINT (-87.669834 42.009469),60626-20201219
60639,01/07/2021,60,659,35,624,0.007,25,35,0,88204,POINT (-87.75531 41.920609),60639-20210107
60608,01/10/2021,98,1720,87,1478,0.018,11,242,0.003,80059,POINT (-87.670366 41.849879),60608-20210110
60637,12/23/2020,68,324,68,324,0.007,0,0,0,47300,POINT (-87.604053 41.780991),60637-20201223
60644,12/22/2020,9,56,9,56,0.001,0,0,0,46591,POINT (-87.756863 41.881113),60644-20201222
60624,12/18/2020,9,18,9,18,0.001,0,0,0,34892,POINT (-87.722735 41.879417),60624-20201218
60624,12/23/2020,8,57,8,57,0.002,0,0,0,34892,POINT (-87.722735 41.879417),60624-20201223
60618,01/11/2021,218,2830,77,2211,0.023,141,619,0.007,94907,POINT (-87.703343 41.946699),60618-20210111
60657,12/30/2020,215,1995,215,1995,0.028,0,0,0,70958,POINT (-87.658216 41.939715),60657-20201230
60630,01/01/2021,0,649,0,649,0.012,0,0,0,56433,POINT (-87.759611 41.971261),60630-20210101
60827,01/28/2021,8,67,6,57,0.002,2,10,0,28483,POINT (-87.633087 41.650765),60827-20210128
60621,01/15/2021,4,310,4,281,0.01,0,29,0.001,28018,POINT (-87.638812 41.776931),60621-20210115
60649,01/02/2021,6,312,6,312,0.007,0,0,0,46633,POINT (-87.571522 41.762202),60649-20210102
60629,01/04/2021,42,601,41,600,0.005,1,1,0,110029,POINT (-87.711565 41.777061),60629-20210104
60607,01/08/2021,276,2259,71,1885,0.064,205,374,0.013,29293,POINT (-87.652727 41.876104),60607-20210108
60640,12/20/2020,16,326,16,326,0.005,0,0,0,69363,POINT (-87.662232 41.971888),60640-20201220
60657,12/17/2020,131,141,131,141,0.002,0,0,0,70958,POINT (-87.658216 41.939715),60657-20201217
60653,01/05/2021,29,456,26,452,0.014,3,4,0,33154,POINT (-87.611244 41.819261),60653-20210105
60642,01/21/2021,96,1939,73,1293,0.066,23,646,0.033,19716,POINT (-87.657821 41.899935),60642-20210121
60644,01/08/2021,35,628,25,611,0.013,10,17,0,46591,POINT (-87.756863 41.881113),60644-20210108
60646,01/18/2021,45,1338,31,1014,0.035,14,324,0.011,28569,POINT (-87.761826 41.993931),60646-20210118
60605,12/20/2020,73,637,73,637,0.022,0,0,0,29060,POINT (-87.623449 41.867824),60605-20201220
60666,01/12/2021,0,0,0,0,0,0,0,0,0,POINT (-87.896371 41.979511),60666-20210112
60647,01/05/2021,116,1600,107,1585,0.018,9,15,0,87633,POINT (-87.701101 41.921058),60647-20210105
60602,12/27/2020,0,30,0,30,0.026,0,0,0,1145,POINT (-87.628309 41.883136),60602-20201227
60616,12/27/2020,0,656,0,656,0.012,0,0,0,54197,POINT (-87.629531 41.844869),60616-20201227
60631,12/24/2020,6,340,6,340,0.012,0,0,0,29529,POINT (-87.813371 41.995019),60631-20201224
60707,01/11/2021,17,224,7,189,0.004,10,35,0.001,43093,POINT (-87.808283 41.921777),60707-20210111
60612,01/01/2021,0,797,0,797,0.024,0,0,0,33735,POINT (-87.687011 41.88004),60612-20210101
60610,12/31/2020,24,898,24,898,0.022,0,0,0,40548,POINT (-87.63581 41.90455),60610-20201231
60646,12/17/2020,13,13,13,13,0,0,0,0,28569,POINT (-87.761826 41.993931),60646-20201217
60610,01/09/2021,104,1665,23,1305,0.032,81,360,0.009,40548,POINT (-87.63581 41.90455),60610-20210109
60606,01/26/2021,21,415,19,285,0.087,2,130,0.04,3287,POINT (-87.63676 41.882634),60606-20210126
60602,01/07/2021,2,63,0,60,0.052,2,3,0.003,1145,POINT (-87.628309 41.883136),60602-20210107
60630,01/06/2021,81,985,61,961,0.017,20,24,0,56433,POINT (-87.759611 41.971261),60630-20210106
60623,01/15/2021,47,1101,46,964,0.012,1,137,0.002,81283,POINT (-87.717446 41.850321),60623-20210115
Unknown,02/01/2021,10,951,9,815,0,1,136,0,0,,Unknown-20210201
60620,01/02/2021,6,262,6,262,0.004,0,0,0,67711,POINT (-87.651656 41.740873),60620-20210102
60647,12/21/2020,146,678,146,678,0.008,0,0,0,87633,POINT (-87.701101 41.921058),60647-20201221
60655,12/29/2020,42,437,42,437,0.015,0,0,0,28569,POINT (-87.701434 41.696456),60655-20201229
60641,12/23/2020,49,406,49,406,0.006,0,0,0,69880,POINT (-87.746791 41.946682),60641-20201223
60607,12/20/2020,31,541,31,541,0.018,0,0,0,29293,POINT (-87.652727 41.876104),60607-20201220
60619,01/02/2021,7,274,7,274,0.004,0,0,0,61207,POINT (-87.60569 41.744737),60619-20210102
60609,12/23/2020,35,172,35,172,0.003,0,0,0,60939,POINT (-87.653382 41.812017),60609-20201223
60616,01/07/2021,194,1442,107,1304,0.024,87,138,0.003,54197,POINT (-87.629531 41.844869),60616-20210107
60632,12/16/2020,3,3,3,3,0,0,0,0,89857,POINT (-87.711251 41.810038),60632-20201216
60655,01/01/2021,0,526,0,526,0.018,0,0,0,28569,POINT (-87.701434 41.696456),60655-20210101
60614,12/27/2020,2,1320,2,1320,0.018,0,0,0,71954,POINT (-87.652064 41.922605),60614-20201227
60620,12/18/2020,38,53,38,53,0.001,0,0,0,67711,POINT (-87.651656 41.740873),60620-20201218
60637,01/04/2021,70,780,64,769,0.016,6,11,0,47300,POINT (-87.604053 41.780991),60637-20210104
60601,12/28/2020,22,338,22,338,0.022,0,0,0,15083,POINT (-87.622844 41.886262),60601-20201228
60617,12/20/2020,10,82,10,82,0.001,0,0,0,83553,POINT (-87.556897 41.721257),60617-20201220
60605,01/16/2021,49,3468,26,2261,0.078,23,1207,0.042,29060,POINT (-87.623449 41.867824),60605-20210116
60631,12/31/2020,16,470,16,470,0.016,0,0,0,29529,POINT (-87.813371 41.995019),60631-20201231
60620,01/09/2021,21,634,17,570,0.008,4,64,0.001,67711,POINT (-87.651656 41.740873),60620-20210109
60666,12/28/2020,0,0,0,0,0,0,0,0,0,POINT (-87.896371 41.979511),60666-20201228
60633,01/31/2021,2,408,2,336,0.026,0,72,0.006,12689,POINT (-87.556037 41.653147),60633-20210131
60651,01/09/2021,17,470,11,427,0.007,6,43,0.001,63492,POINT (-87.741017 41.901964),60651-20210109
60641,12/26/2020,13,441,13,441,0.006,0,0,0,69880,POINT (-87.746791 41.946682),60641-20201226
Unknown,01/02/2021,1,87,1,87,0,0,0,0,0,,Unknown-20210102
60621,01/04/2021,8,188,8,188,0.007,0,0,0,28018,POINT (-87.638812 41.776931),60621-20210104
60617,01/06/2021,53,522,47,511,0.006,6,11,0,83553,POINT (-87.556897 41.721257),60617-20210106
60657,12/26/2020,50,1489,50,1489,0.021,0,0,0,70958,POINT (-87.658216 41.939715),60657-20201226
60614,12/20/2020,48,678,48,678,0.009,0,0,0,71954,POINT (-87.652064 41.922605),60614-20201220
60827,01/11/2021,1,20,1,18,0.001,0,2,0,28483,POINT (-87.633087 41.650765),60827-20210111
60633,12/26/2020,0,26,0,26,0.002,0,0,0,12689,POINT (-87.556037 41.653147),60633-20201226
60623,12/21/2020,31,87,31,87,0.001,0,0,0,81283,POINT (-87.717446 41.850321),60623-20201221
60643,12/25/2020,0,311,0,311,0.006,0,0,0,48887,POINT (-87.662381 41.700445),60643-20201225
60629,12/15/2020,0,0,0,0,0,0,0,0,110029,POINT (-87.711565 41.777061),60629-20201215
60614,12/22/2020,201,1151,201,1151,0.016,0,0,0,71954,POINT (-87.652064 41.922605),60614-20201222
60608,12/29/2020,96,702,96,702,0.009,0,0,0,80059,POINT (-87.670366 41.849879),60608-20201229
60619,01/05/2021,36,349,34,345,0.006,2,4,0,61207,POINT (-87.60569 41.744737),60619-20210105
60632,12/31/2020,30,402,30,402,0.004,0,0,0,89857,POINT (-87.711251 41.810038),60632-20201231
60642,12/27/2020,0,519,0,519,0.026,0,0,0,19716,POINT (-87.657821 41.899935),60642-20201227
60633,12/20/2020,1,10,1,10,0.001,0,0,0,12689,POINT (-87.556037 41.653147),60633-20201220
60606,01/11/2021,23,228,5,161,0.049,18,67,0.02,3287,POINT (-87.63676 41.882634),60606-20210111
60605,12/28/2020,55,1270,55,1270,0.044,0,0,0,29060,POINT (-87.623449 41.867824),60605-20201228
60619,12/19/2020,11,45,11,45,0.001,0,0,0,61207,POINT (-87.60569 41.744737),60619-20201219
60637,01/14/2021,61,1458,46,1126,0.024,15,332,0.007,47300,POINT (-87.604053 41.780991),60637-20210114
60625,12/17/2020,33,37,33,37,0,0,0,0,79444,POINT (-87.701816 41.971155),60625-20201217
60625,01/01/2021,1,986,1,986,0.012,0,0,0,79444,POINT (-87.701816 41.971155),60625-20210101
60628,01/02/2021,3,234,3,234,0.004,0,0,0,64254,POINT (-87.621537 41.694192),60628-20210102
60645,01/09/2021,39,1293,17,1157,0.024,22,136,0.003,47270,POINT (-87.695049 42.008927),60645-20210109
60651,01/20/2021,106,912,70,737,0.012,36,175,0.003,63492,POINT (-87.741017 41.901964),60651-20210120
60661,01/05/2021,25,537,24,531,0.051,1,6,0.001,10354,POINT (-87.644283 41.882786),60661-20210105
60637,12/18/2020,55,81,55,81,0.002,0,0,0,47300,POINT (-87.604053 41.780991),60637-20201218
60652,12/22/2020,22,115,22,115,0.003,0,0,0,43447,POINT (-87.714238 41.745398),60652-20201222
60645,12/25/2020,0,280,0,280,0.006,0,0,0,47270,POINT (-87.695049 42.008927),60645-20201225
60608,12/24/2020,32,564,32,564,0.007,0,0,0,80059,POINT (-87.670366 41.849879),60608-20201224
60666,12/15/2020,0,0,0,0,0,0,0,0,0,POINT (-87.896371 41.979511),60666-20201215
60606,12/25/2020,0,90,0,90,0.027,0,0,0,3287,POINT (-87.63676 41.882634),60606-20201225
60666,01/22/2021,0,2,0,2,0,0,0,0,0,POINT (-87.896371 41.979511),60666-20210122
60666,01/16/2021,0,1,0,1,0,0,0,0,0,POINT (-87.896371 41.979511),60666-20210116
60661,01/15/2021,27,1033,25,699,0.068,2,334,0.032,10354,POINT (-87.644283 41.882786),60661-20210115
60657,12/21/2020,280,1040,280,1040,0.015,0,0,0,70958,POINT (-87.658216 41.939715),60657-20201221
60636,12/26/2020,2,31,2,31,0.001,0,0,0,30024,POINT (-87.668597 41.77599),60636-20201226
60601,12/15/2020,0,0,0,0,0,0,0,0,15083,POINT (-87.622844 41.886262),60601-20201215
60621,12/18/2020,4,9,4,9,0,0,0,0,28018,POINT (-87.638812 41.776931),60621-20201218
60655,01/03/2021,12,663,12,663,0.023,0,0,0,28569,POINT (-87.701434 41.696456),60655-20210103
60636,12/31/2020,9,82,9,82,0.003,0,0,0,30024,POINT (-87.668597 41.77599),60636-20201231
60653,12/19/2020,21,58,21,58,0.002,0,0,0,33154,POINT (-87.611244 41.819261),60653-20201219
60623,01/20/2021,115,1360,84,1142,0.014,31,218,0.003,81283,POINT (-87.717446 41.850321),60623-20210120
60638,12/28/2020,30,357,30,357,0.006,0,0,0,58669,POINT (-87.771902 41.787032),60638-20201228
60626,12/15/2020,0,0,0,0,0,0,0,0,50544,POINT (-87.669834 42.009469),60626-20201215
60630,12/17/2020,29,33,29,33,0.001,0,0,0,56433,POINT (-87.759611 41.971261),60630-20201217
60625,12/27/2020,0,639,0,639,0.008,0,0,0,79444,POINT (-87.701816 41.971155),60625-20201227
60707,01/04/2021,7,133,6,132,0.003,1,1,0,43093,POINT (-87.808283 41.921777),60707-20210104
60606,01/15/2021,7,268,6,180,0.055,1,88,0.027,3287,POINT (-87.63676 41.882634),60606-20210115
60633,01/21/2021,17,201,15,162,0.013,2,39,0.003,12689,POINT (-87.556037 41.653147),60633-20210121
60637,01/19/2021,209,2088,178,1600,0.034,31,488,0.01,47300,POINT (-87.604053 41.780991),60637-20210119
60644,01/12/2021,38,702,32,664,0.014,6,38,0.001,46591,POINT (-87.756863 41.881113),60644-20210112
Unknown,12/31/2020,3,86,3,86,0,0,0,0,0,,Unknown-20201231
60645,12/30/2020,152,597,152,597,0.013,0,0,0,47270,POINT (-87.695049 42.008927),60645-20201230
60646,01/08/2021,97,786,22,667,0.023,75,119,0.004,28569,POINT (-87.761826 41.993931),60646-20210108
60607,01/04/2021,159,1606,150,1596,0.054,9,10,0,29293,POINT (-87.652727 41.876104),60607-20210104
60614,01/01/2021,0,1794,0,1794,0.025,0,0,0,71954,POINT (-87.652064 41.922605),60614-20210101
60610,12/17/2020,62,64,62,64,0.002,0,0,0,40548,POINT (-87.63581 41.90455),60610-20201217
60639,01/03/2021,11,410,11,410,0.005,0,0,0,88204,POINT (-87.75531 41.920609),60639-20210103
60647,01/10/2021,46,2420,23,1896,0.022,23,524,0.006,87633,POINT (-87.701101 41.921058),60647-20210110
60609,12/28/2020,24,205,24,205,0.003,0,0,0,60939,POINT (-87.653382 41.812017),60609-20201228
60602,01/11/2021,5,84,0,64,0.056,5,20,0.017,1145,POINT (-87.628309 41.883136),60602-20210111
60646,01/03/2021,4,473,4,473,0.017,0,0,0,28569,POINT (-87.761826 41.993931),60646-20210103
60637,12/28/2020,14,377,14,377,0.008,0,0,0,47300,POINT (-87.604053 41.780991),60637-20201228
60606,01/22/2021,17,356,16,236,0.072,1,120,0.037,3287,POINT (-87.63676 41.882634),60606-20210122
60640,12/16/2020,3,3,3,3,0,0,0,0,69363,POINT (-87.662232 41.971888),60640-20201216
60632,01/13/2021,61,876,41,749,0.008,20,127,0.001,89857,POINT (-87.711251 41.810038),60632-20210113
60609,01/04/2021,30,374,30,374,0.006,0,0,0,60939,POINT (-87.653382 41.812017),60609-20210104
60621,01/19/2021,17,346,12,307,0.011,5,39,0.001,28018,POINT (-87.638812 41.776931),60621-20210119
60649,01/06/2021,22,395,21,390,0.008,1,5,0,46633,POINT (-87.571522 41.762202),60649-20210106
60619,12/16/2020,0,0,0,0,0,0,0,0,61207,POINT (-87.60569 41.744737),60619-20201216
60707,12/18/2020,15,17,15,17,0,0,0,0,43093,POINT (-87.808283 41.921777),60707-20201218
60616,12/23/2020,76,612,76,612,0.011,0,0,0,54197,POINT (-87.629531 41.844869),60616-20201223
60607,12/24/2020,43,995,43,995,0.034,0,0,0,29293,POINT (-87.652727 41.876104),60607-20201224
60624,01/02/2021,6,124,6,124,0.004,0,0,0,34892,POINT (-87.722735 41.879417),60624-20210102
60653,01/02/2021,1,399,1,399,0.012,0,0,0,33154,POINT (-87.611244 41.819261),60653-20210102
60624,01/04/2021,22,147,22,147,0.004,0,0,0,34892,POINT (-87.722735 41.879417),60624-20210104
60651,12/19/2020,11,44,11,44,0.001,0,0,0,63492,POINT (-87.741017 41.901964),60651-20201219
60618,12/22/2020,136,764,136,764,0.008,0,0,0,94907,POINT (-87.703343 41.946699),60618-20201222
Unknown,01/15/2021,51,342,51,306,0,0,36,0,0,,Unknown-20210115
60643,12/21/2020,61,214,61,214,0.004,0,0,0,48887,POINT (-87.662381 41.700445),60643-20201221
60629,12/19/2020,33,102,33,102,0.001,0,0,0,110029,POINT (-87.711565 41.777061),60629-20201219
60628,12/23/2020,20,101,20,101,0.002,0,0,0,64254,POINT (-87.621537 41.694192),60628-20201223
60652,12/26/2020,2,156,2,156,0.004,0,0,0,43447,POINT (-87.714238 41.745398),60652-20201226
60637,12/31/2020,46,618,46,618,0.013,0,0,0,47300,POINT (-87.604053 41.780991),60637-20201231
60634,12/23/2020,53,449,53,449,0.006,0,0,0,75082,POINT (-87.797373 41.944967),60634-20201223
60606,01/20/2021,23,316,8,202,0.061,15,114,0.035,3287,POINT (-87.63676 41.882634),60606-20210120
60625,12/22/2020,67,497,67,497,0.006,0,0,0,79444,POINT (-87.701816 41.971155),60625-20201222
60629,01/11/2021,70,1012,25,852,0.008,45,160,0.001,110029,POINT (-87.711565 41.777061),60629-20210111
60655,12/23/2020,21,363,21,363,0.013,0,0,0,28569,POINT (-87.701434 41.696456),60655-20201223
60644,12/28/2020,58,143,58,143,0.003,0,0,0,46591,POINT (-87.756863 41.881113),60644-20201228
60614,12/18/2020,321,453,321,453,0.006,0,0,0,71954,POINT (-87.652064 41.922605),60614-20201218
60647,01/13/2021,412,3261,312,2395,0.027,100,866,0.01,87633,POINT (-87.701101 41.921058),60647-20210113
60651,01/13/2021,46,616,29,524,0.008,17,92,0.001,63492,POINT (-87.741017 41.901964),60651-20210113
60827,01/26/2021,4,54,4,47,0.002,0,7,0,28483,POINT (-87.633087 41.650765),60827-20210126
60613,12/21/2020,157,559,157,559,0.011,0,0,0,50761,POINT (-87.661343 41.953742),60613-20201221
60638,12/17/2020,22,22,22,22,0,0,0,0,58669,POINT (-87.771902 41.787032),60638-20201217
60620,01/07/2021,52,531,32,498,0.007,20,33,0,67711,POINT (-87.651656 41.740873),60620-20210107
60636,12/17/2020,3,3,3,3,0,0,0,0,30024,POINT (-87.668597 41.77599),60636-20201217
60612,12/28/2020,58,584,58,584,0.017,0,0,0,33735,POINT (-87.687011 41.88004),60612-20201228
60827,01/09/2021,1,19,1,17,0.001,0,2,0,28483,POINT (-87.633087 41.650765),60827-20210109
60628,12/18/2020,21,28,21,28,0,0,0,0,64254,POINT (-87.621537 41.694192),60628-20201218
60651,12/22/2020,17,83,17,83,0.001,0,0,0,63492,POINT (-87.741017 41.901964),60651-20201222
60612,12/15/2020,0,0,0,0,0,0,0,0,33735,POINT (-87.687011 41.88004),60612-20201215
60641,12/20/2020,15,215,15,215,0.003,0,0,0,69880,POINT (-87.746791 41.946682),60641-20201220
60649,01/04/2021,17,340,15,338,0.007,2,2,0,46633,POINT (-87.571522 41.762202),60649-20210104
60621,12/17/2020,5,5,5,5,0,0,0,0,28018,POINT (-87.638812 41.776931),60621-20201217
60631,12/21/2020,74,280,74,280,0.009,0,0,0,29529,POINT (-87.813371 41.995019),60631-20201221
60617,12/29/2020,49,291,49,291,0.003,0,0,0,83553,POINT (-87.556897 41.721257),60617-20201229
Unknown,12/26/2020,3,40,3,40,0,0,0,0,0,,Unknown-20201226
60631,12/19/2020,74,182,74,182,0.006,0,0,0,29529,POINT (-87.813371 41.995019),60631-20201219
60647,12/31/2020,60,1339,60,1339,0.015,0,0,0,87633,POINT (-87.701101 41.921058),60647-20201231
Unknown,01/27/2021,57,801,42,684,0,15,117,0,0,,Unknown-20210127
60666,12/25/2020,0,0,0,0,0,0,0,0,0,POINT (-87.896371 41.979511),60666-20201225
60620,12/23/2020,16,122,16,122,0.002,0,0,0,67711,POINT (-87.651656 41.740873),60620-20201223
60636,01/01/2021,0,82,0,82,0.003,0,0,0,30024,POINT (-87.668597 41.77599),60636-20210101
60642,01/14/2021,35,1530,19,1040,0.053,16,490,0.025,19716,POINT (-87.657821 41.899935),60642-20210114
60606,12/29/2020,5,102,5,102,0.031,0,0,0,3287,POINT (-87.63676 41.882634),60606-20201229
60628,01/06/2021,29,424,28,422,0.007,1,2,0,64254,POINT (-87.621537 41.694192),60628-20210106
60666,01/26/2021,1,4,1,4,0,0,0,0,0,POINT (-87.896371 41.979511),60666-20210126
60639,01/15/2021,66,1299,65,1099,0.012,1,200,0.002,88204,POINT (-87.75531 41.920609),60639-20210115
60661,12/22/2020,43,313,43,313,0.03,0,0,0,10354,POINT (-87.644283 41.882786),60661-20201222
60612,12/27/2020,0,526,0,526,0.016,0,0,0,33735,POINT (-87.687011 41.88004),60612-20201227
60617,01/10/2021,6,685,1,605,0.007,5,80,0.001,83553,POINT (-87.556897 41.721257),60617-20210110
60617,12/24/2020,10,199,10,199,0.002,0,0,0,83553,POINT (-87.556897 41.721257),60617-20201224
60633,01/01/2021,0,48,0,48,0.004,0,0,0,12689,POINT (-87.556037 41.653147),60633-20210101
60666,12/30/2020,0,0,0,0,0,0,0,0,0,POINT (-87.896371 41.979511),60666-20201230
60666,01/09/2021,0,0,0,0,0,0,0,0,0,POINT (-87.896371 41.979511),60666-20210109
60609,12/30/2020,64,306,64,306,0.005,0,0,0,60939,POINT (-87.653382 41.812017),60609-20201230
60618,01/15/2021,128,3570,114,2686,0.028,14,884,0.009,94907,POINT (-87.703343 41.946699),60618-20210115
60660,12/25/2020,0,341,0,341,0.008,0,0,0,44498,POINT (-87.666362 41.991062),60660-20201225
60609,01/16/2021,82,1043,77,863,0.014,5,180,0.003,60939,POINT (-87.653382 41.812017),60609-20210116
60642,12/28/2020,27,546,27,546,0.028,0,0,0,19716,POINT (-87.657821 41.899935),60642-20201228
60707,01/08/2021,19,187,12,171,0.004,7,16,0,43093,POINT (-87.808283 41.921777),60707-20210108
60605,12/15/2020,0,0,0,0,0,0,0,0,29060,POINT (-87.623449 41.867824),60605-20201215
60623,01/14/2021,56,1054,48,918,0.011,8,136,0.002,81283,POINT (-87.717446 41.850321),60623-20210114
60621,01/18/2021,10,329,7,295,0.011,3,34,0.001,28018,POINT (-87.638812 41.776931),60621-20210118
60653,12/23/2020,26,159,26,159,0.005,0,0,0,33154,POINT (-87.611244 41.819261),60653-20201223
60640,01/02/2021,34,1192,34,1192,0.017,0,0,0,69363,POINT (-87.662232 41.971888),60640-20210102
60656,01/10/2021,13,538,6,415,0.015,7,123,0.004,28218,POINT (-87.817934 41.974566),60656-20210110
60629,01/05/2021,55,656,53,653,0.006,2,3,0,110029,POINT (-87.711565 41.777061),60629-20210105
60653,01/13/2021,47,842,27,693,0.021,20,149,0.004,33154,POINT (-87.611244 41.819261),60653-20210113
60609,12/15/2020,0,0,0,0,0,0,0,0,60939,POINT (-87.653382 41.812017),60609-20201215
60651,12/17/2020,5,5,5,5,0,0,0,0,63492,POINT (-87.741017 41.901964),60651-20201217
60630,12/24/2020,11,424,11,424,0.008,0,0,0,56433,POINT (-87.759611 41.971261),60630-20201224
60661,01/02/2021,10,471,10,471,0.045,0,0,0,10354,POINT (-87.644283 41.882786),60661-20210102
60607,12/28/2020,52,1060,52,1060,0.036,0,0,0,29293,POINT (-87.652727 41.876104),60607-20201228
60666,01/19/2021,1,2,1,2,0,0,0,0,0,POINT (-87.896371 41.979511),60666-20210119
60632,12/18/2020,22,37,22,37,0,0,0,0,89857,POINT (-87.711251 41.810038),60632-20201218
60666,01/04/2021,0,0,0,0,0,0,0,0,0,POINT (-87.896371 41.979511),60666-20210104
60661,01/12/2021,57,917,19,627,0.061,38,290,0.028,10354,POINT (-87.644283 41.882786),60661-20210112
60610,01/08/2021,272,1561,101,1282,0.032,171,279,0.007,40548,POINT (-87.63581 41.90455),60610-20210108
60638,01/01/2021,2,539,2,539,0.009,0,0,0,58669,POINT (-87.771902 41.787032),60638-20210101
60827,12/25/2020,0,7,0,7,0,0,0,0,28483,POINT (-87.633087 41.650765),60827-20201225
60623,12/22/2020,25,112,25,112,0.001,0,0,0,81283,POINT (-87.717446 41.850321),60623-20201222
60640,12/28/2020,83,791,83,791,0.011,0,0,0,69363,POINT (-87.662232 41.971888),60640-20201228
60649,01/09/2021,18,603,11,557,0.012,7,46,0.001,46633,POINT (-87.571522 41.762202),60649-20210109
60637,01/15/2021,125,1583,94,1220,0.026,31,363,0.008,47300,POINT (-87.604053 41.780991),60637-20210115
60649,12/25/2020,0,118,0,118,0.003,0,0,0,46633,POINT (-87.571522 41.762202),60649-20201225
60619,01/10/2021,11,514,6,463,0.008,5,51,0.001,61207,POINT (-87.60569 41.744737),60619-20210110
60618,12/18/2020,216,276,216,276,0.003,0,0,0,94907,POINT (-87.703343 41.946699),60618-20201218
60629,12/27/2020,1,286,1,286,0.003,0,0,0,110029,POINT (-87.711565 41.777061),60629-20201227
60646,12/30/2020,43,422,43,422,0.015,0,0,0,28569,POINT (-87.761826 41.993931),60646-20201230
60631,01/01/2021,0,470,0,470,0.016,0,0,0,29529,POINT (-87.813371 41.995019),60631-20210101
60656,12/26/2020,3,196,3,196,0.007,0,0,0,28218,POINT (-87.817934 41.974566),60656-20201226
60624,12/31/2020,16,118,16,118,0.003,0,0,0,34892,POINT (-87.722735 41.879417),60624-20201231
60646,12/24/2020,5,306,5,306,0.011,0,0,0,28569,POINT (-87.761826 41.993931),60646-20201224
60827,01/31/2021,1,81,1,69,0.002,0,12,0,28483,POINT (-87.633087 41.650765),60827-20210131
60602,12/19/2020,5,13,5,13,0.011,0,0,0,1145,POINT (-87.628309 41.883136),60602-20201219
60644,12/25/2020,0,82,0,82,0.002,0,0,0,46591,POINT (-87.756863 41.881113),60644-20201225
60620,12/25/2020,0,132,0,132,0.002,0,0,0,67711,POINT (-87.651656 41.740873),60620-20201225
60649,12/20/2020,2,48,2,48,0.001,0,0,0,46633,POINT (-87.571522 41.762202),60649-20201220
60707,01/03/2021,4,126,4,126,0.003,0,0,0,43093,POINT (-87.808283 41.921777),60707-20210103
60622,12/23/2020,123,1333,123,1333,0.025,0,0,0,53294,POINT (-87.681818 41.902762),60622-20201223
60625,12/18/2020,160,197,160,197,0.002,0,0,0,79444,POINT (-87.701816 41.971155),60625-20201218
60607,01/02/2021,23,1433,23,1433,0.049,0,0,0,29293,POINT (-87.652727 41.876104),60607-20210102
60630,12/18/2020,96,129,96,129,0.002,0,0,0,56433,POINT (-87.759611 41.971261),60630-20201218
60639,12/31/2020,40,377,40,377,0.004,0,0,0,88204,POINT (-87.75531 41.920609),60639-20201231
60657,12/23/2020,144,1389,144,1389,0.02,0,0,0,70958,POINT (-87.658216 41.939715),60657-20201223
60628,01/19/2021,99,908,70,764,0.012,29,144,0.002,64254,POINT (-87.621537 41.694192),60628-20210119
60636,01/18/2021,12,254,7,223,0.007,5,31,0.001,30024,POINT (-87.668597 41.77599),60636-20210118
60638,12/22/2020,53,277,53,277,0.005,0,0,0,58669,POINT (-87.771902 41.787032),60638-20201222
60647,01/07/2021,206,1909,79,1739,0.02,127,170,0.002,87633,POINT (-87.701101 41.921058),60647-20210107
60707,12/22/2020,14,56,14,56,0.001,0,0,0,43093,POINT (-87.808283 41.921777),60707-20201222
60632,01/09/2021,36,685,26,638,0.007,10,47,0.001,89857,POINT (-87.711251 41.810038),60632-20210109
60660,01/09/2021,57,1775,24,1588,0.036,33,187,0.004,44498,POINT (-87.666362 41.991062),60660-20210109
60633,01/30/2021,24,406,20,334,0.026,4,72,0.006,12689,POINT (-87.556037 41.653147),60633-20210130
60643,01/05/2021,38,550,32,543,0.011,6,7,0,48887,POINT (-87.662381 41.700445),60643-20210105
60645,01/01/2021,0,641,0,641,0.014,0,0,0,47270,POINT (-87.695049 42.008927),60645-20210101
60645,01/08/2021,120,1254,56,1140,0.024,64,114,0.002,47270,POINT (-87.695049 42.008927),60645-20210108
60646,01/10/2021,10,848,6,683,0.024,4,165,0.006,28569,POINT (-87.761826 41.993931),60646-20210110
60647,01/17/2021,33,3824,24,2887,0.033,9,937,0.011,87633,POINT (-87.701101 41.921058),60647-20210117
60619,12/26/2020,0,121,0,121,0.002,0,0,0,61207,POINT (-87.60569 41.744737),60619-20201226
60616,12/28/2020,55,711,55,711,0.013,0,0,0,54197,POINT (-87.629531 41.844869),60616-20201228
60827,01/22/2021,3,48,3,42,0.001,0,6,0,28483,POINT (-87.633087 41.650765),60827-20210122
60636,01/05/2021,12,110,11,109,0.004,1,1,0,30024,POINT (-87.668597 41.77599),60636-20210105
60619,12/28/2020,32,153,32,153,0.002,0,0,0,61207,POINT (-87.60569 41.744737),60619-20201228
60610,01/01/2021,2,900,2,900,0.022,0,0,0,40548,POINT (-87.63581 41.90455),60610-20210101
60633,01/23/2021,16,244,14,197,0.016,2,47,0.004,12689,POINT (-87.556037 41.653147),60633-20210123
60606,01/03/2021,0,129,0,129,0.039,0,0,0,3287,POINT (-87.63676 41.882634),60606-20210103
60605,12/23/2020,133,1163,133,1163,0.04,0,0,0,29060,POINT (-87.623449 41.867824),60605-20201223
60644,01/19/2021,26,986,9,893,0.019,17,93,0.002,46591,POINT (-87.756863 41.881113),60644-20210119
60651,01/23/2021,48,1206,45,1015,0.016,3,191,0.003,63492,POINT (-87.741017 41.901964),60651-20210123
60666,12/20/2020,0,0,0,0,0,0,0,0,0,POINT (-87.896371 41.979511),60666-20201220
60666,12/18/2020,0,0,0,0,0,0,0,0,0,POINT (-87.896371 41.979511),60666-20201218
Unknown,01/24/2021,1,688,1,603,0,0,85,0,0,,Unknown-20210124
60647,12/16/2020,8,8,8,8,0,0,0,0,87633,POINT (-87.701101 41.921058),60647-20201216
60640,12/18/2020,173,215,173,215,0.003,0,0,0,69363,POINT (-87.662232 41.971888),60640-20201218
60652,12/21/2020,30,93,30,93,0.002,0,0,0,43447,POINT (-87.714238 41.745398),60652-20201221
60655,12/19/2020,53,184,53,184,0.006,0,0,0,28569,POINT (-87.701434 41.696456),60655-20201219
60606,12/19/2020,13,49,13,49,0.015,0,0,0,3287,POINT (-87.63676 41.882634),60606-20201219
60621,12/27/2020,0,34,0,34,0.001,0,0,0,28018,POINT (-87.638812 41.776931),60621-20201227
Unknown,01/10/2021,1,150,0,141,0,1,9,0,0,,Unknown-20210110
60631,12/23/2020,24,334,24,334,0.011,0,0,0,29529,POINT (-87.813371 41.995019),60631-20201223
60622,12/16/2020,3,3,3,3,0,0,0,0,53294,POINT (-87.681818 41.902762),60622-20201216
60613,12/17/2020,48,55,48,55,0.001,0,0,0,50761,POINT (-87.661343 41.953742),60613-20201217
60607,12/16/2020,4,5,4,5,0,0,0,0,29293,POINT (-87.652727 41.876104),60607-20201216
60661,01/07/2021,65,630,22,570,0.055,43,60,0.006,10354,POINT (-87.644283 41.882786),60661-20210107
60661,12/26/2020,8,359,8,359,0.035,0,0,0,10354,POINT (-87.644283 41.882786),60661-20201226
60633,01/13/2021,9,121,6,99,0.008,3,22,0.002,12689,POINT (-87.556037 41.653147),60633-20210113
60642,12/19/2020,78,265,78,265,0.013,0,0,0,19716,POINT (-87.657821 41.899935),60642-20201219
60642,01/10/2021,30,1219,9,918,0.047,21,301,0.015,19716,POINT (-87.657821 41.899935),60642-20210110
60602,12/29/2020,5,39,5,39,0.034,0,0,0,1145,POINT (-87.628309 41.883136),60602-20201229
60827,01/05/2021,0,11,0,11,0,0,0,0,28483,POINT (-87.633087 41.650765),60827-20210105
60639,12/19/2020,34,84,34,84,0.001,0,0,0,88204,POINT (-87.75531 41.920609),60639-20201219
60608,12/16/2020,0,0,0,0,0,0,0,0,80059,POINT (-87.670366 41.849879),60608-20201216
60656,12/23/2020,14,191,14,191,0.007,0,0,0,28218,POINT (-87.817934 41.974566),60656-20201223
60638,01/06/2021,37,703,31,690,0.012,6,13,0,58669,POINT (-87.771902 41.787032),60638-20210106
60620,01/14/2021,40,834,34,705,0.01,6,129,0.002,67711,POINT (-87.651656 41.740873),60620-20210114
60660,12/29/2020,58,440,58,440,0.01,0,0,0,44498,POINT (-87.666362 41.991062),60660-20201229
60644,01/14/2021,32,890,24,830,0.018,8,60,0.001,46591,POINT (-87.756863 41.881113),60644-20210114
60651,01/18/2021,42,771,23,650,0.01,19,121,0.002,63492,POINT (-87.741017 41.901964),60651-20210118
60653,01/09/2021,74,658,56,585,0.018,18,73,0.002,33154,POINT (-87.611244 41.819261),60653-20210109
60608,01/02/2021,14,924,14,924,0.012,0,0,0,80059,POINT (-87.670366 41.849879),60608-20210102
60652,12/31/2020,20,381,20,381,0.009,0,0,0,43447,POINT (-87.714238 41.745398),60652-20201231
Unknown,01/07/2021,9,128,7,126,0,2,2,0,0,,Unknown-20210107
60632,12/23/2020,25,143,25,143,0.002,0,0,0,89857,POINT (-87.711251 41.810038),60632-20201223
60645,12/17/2020,16,21,16,21,0,0,0,0,47270,POINT (-87.695049 42.008927),60645-20201217
60647,12/27/2020,0,979,0,979,0.011,0,0,0,87633,POINT (-87.701101 41.921058),60647-20201227
60642,12/24/2020,15,509,15,509,0.026,0,0,0,19716,POINT (-87.657821 41.899935),60642-20201224
Unknown,12/23/2020,8,34,8,34,0,0,0,0,0,,Unknown-20201223
60639,12/26/2020,1,216,1,216,0.002,0,0,0,88204,POINT (-87.75531 41.920609),60639-20201226
60827,12/21/2020,0,4,0,4,0,0,0,0,28483,POINT (-87.633087 41.650765),60827-20201221
60602,01/03/2021,3,47,3,47,0.041,0,0,0,1145,POINT (-87.628309 41.883136),60602-20210103
60618,12/29/2020,157,1167,157,1167,0.012,0,0,0,94907,POINT (-87.703343 41.946699),60618-20201229
60605,01/06/2021,86,1893,42,1797,0.062,44,96,0.003,29060,POINT (-87.623449 41.867824),60605-20210106
60609,01/12/2021,80,824,50,688,0.011,30,136,0.002,60939,POINT (-87.653382 41.812017),60609-20210112
60707,12/27/2020,0,75,0,75,0.002,0,0,0,43093,POINT (-87.808283 41.921777),60707-20201227
60618,01/13/2021,200,3276,107,2445,0.026,93,831,0.009,94907,POINT (-87.703343 41.946699),60618-20210113
60608,01/17/2021,13,2463,10,1935,0.024,3,528,0.007,80059,POINT (-87.670366 41.849879),60608-20210117
60610,12/25/2020,0,642,0,642,0.016,0,0,0,40548,POINT (-87.63581 41.90455),60610-20201225
60637,01/11/2021,50,1261,7,1007,0.021,43,254,0.005,47300,POINT (-87.604053 41.780991),60637-20210111
60645,12/27/2020,0,285,0,285,0.006,0,0,0,47270,POINT (-87.695049 42.008927),60645-20201227
60649,01/14/2021,47,950,40,851,0.018,7,99,0.002,46633,POINT (-87.571522 41.762202),60649-20210114
60653,12/27/2020,0,168,0,168,0.005,0,0,0,33154,POINT (-87.611244 41.819261),60653-20201227
60642,01/25/2021,76,2152,45,1460,0.074,31,692,0.035,19716,POINT (-87.657821 41.899935),60642-20210125
60645,01/17/2021,14,1813,12,1544,0.033,2,269,0.006,47270,POINT (-87.695049 42.008927),60645-20210117
60626,12/23/2020,47,318,47,318,0.006,0,0,0,50544,POINT (-87.669834 42.009469),60626-20201223
60643,12/31/2020,17,456,17,456,0.009,0,0,0,48887,POINT (-87.662381 41.700445),60643-20201231
60636,12/21/2020,8,16,8,16,0.001,0,0,0,30024,POINT (-87.668597 41.77599),60636-20201221
60621,01/11/2021,5,263,2,244,0.009,3,19,0.001,28018,POINT (-87.638812 41.776931),60621-20210111
60651,12/27/2020,0,112,0,112,0.002,0,0,0,63492,POINT (-87.741017 41.901964),60651-20201227
60624,12/27/2020,0,59,0,59,0.002,0,0,0,34892,POINT (-87.722735 41.879417),60624-20201227
60633,12/22/2020,5,19,5,19,0.001,0,0,0,12689,POINT (-87.556037 41.653147),60633-20201222
60631,12/28/2020,16,362,16,362,0.012,0,0,0,29529,POINT (-87.813371 41.995019),60631-20201228
60707,12/17/2020,1,2,1,2,0,0,0,0,43093,POINT (-87.808283 41.921777),60707-20201217
60644,01/04/2021,30,335,30,335,0.007,0,0,0,46591,POINT (-87.756863 41.881113),60644-20210104
60642,01/20/2021,96,1843,45,1220,0.062,51,623,0.032,19716,POINT (-87.657821 41.899935),60642-20210120
60606,01/30/2021,12,486,8,343,0.104,4,143,0.044,3287,POINT (-87.63676 41.882634),60606-20210130
60622,12/31/2020,97,2084,97,2084,0.039,0,0,0,53294,POINT (-87.681818 41.902762),60622-20201231
60640,12/23/2020,78,677,78,677,0.01,0,0,0,69363,POINT (-87.662232 41.971888),60640-20201223
60626,12/24/2020,14,332,14,332,0.007,0,0,0,50544,POINT (-87.669834 42.009469),60626-20201224
60649,12/30/2020,23,294,23,294,0.006,0,0,0,46633,POINT (-87.571522 41.762202),60649-20201230
60660,01/13/2021,102,2079,62,1769,0.04,40,310,0.007,44498,POINT (-87.666362 41.991062),60660-20210113
60644,01/07/2021,17,593,12,586,0.013,5,7,0,46591,POINT (-87.756863 41.881113),60644-20210107
60646,01/14/2021,41,1185,31,889,0.031,10,296,0.01,28569,POINT (-87.761826 41.993931),60646-20210114
60707,01/01/2021,0,120,0,120,0.003,0,0,0,43093,POINT (-87.808283 41.921777),60707-20210101
60656,01/07/2021,45,427,8,384,0.014,37,43,0.002,28218,POINT (-87.817934 41.974566),60656-20210107
60651,01/08/2021,60,453,33,416,0.007,27,37,0.001,63492,POINT (-87.741017 41.901964),60651-20210108
60642,01/03/2021,7,710,7,710,0.036,0,0,0,19716,POINT (-87.657821 41.899935),60642-20210103
60614,12/31/2020,44,1794,44,1794,0.025,0,0,0,71954,POINT (-87.652064 41.922605),60614-20201231
60623,12/26/2020,4,157,4,157,0.002,0,0,0,81283,POINT (-87.717446 41.850321),60623-20201226
60633,12/29/2020,7,37,7,37,0.003,0,0,0,12689,POINT (-87.556037 41.653147),60633-20201229
60616,12/15/2020,0,0,0,0,0,0,0,0,54197,POINT (-87.629531 41.844869),60616-20201215
60642,12/18/2020,135,187,135,187,0.009,0,0,0,19716,POINT (-87.657821 41.899935),60642-20201218
60646,01/02/2021,11,469,11,469,0.016,0,0,0,28569,POINT (-87.761826 41.993931),60646-20210102
60647,12/23/2020,101,930,101,930,0.011,0,0,0,87633,POINT (-87.701101 41.921058),60647-20201223
60606,12/15/2020,0,0,0,0,0,0,0,0,3287,POINT (-87.63676 41.882634),60606-20201215
60612,01/04/2021,80,894,79,893,0.026,1,1,0,33735,POINT (-87.687011 41.88004),60612-20210104
60644,12/17/2020,4,4,4,4,0,0,0,0,46591,POINT (-87.756863 41.881113),60644-20201217
60605,12/27/2020,2,1215,2,1215,0.042,0,0,0,29060,POINT (-87.623449 41.867824),60605-20201227
60631,12/27/2020,0,346,0,346,0.012,0,0,0,29529,POINT (-87.813371 41.995019),60631-20201227
60608,01/16/2021,57,2450,52,1925,0.024,5,525,0.007,80059,POINT (-87.670366 41.849879),60608-20210116
60649,12/17/2020,13,13,13,13,0,0,0,0,46633,POINT (-87.571522 41.762202),60649-20201217
60606,12/30/2020,16,118,16,118,0.036,0,0,0,3287,POINT (-87.63676 41.882634),60606-20201230
60636,01/09/2021,6,169,5,157,0.005,1,12,0,30024,POINT (-87.668597 41.77599),60636-20210109
60641,12/22/2020,56,357,56,357,0.005,0,0,0,69880,POINT (-87.746791 41.946682),60641-20201222
60632,01/12/2021,76,815,47,708,0.008,29,107,0.001,89857,POINT (-87.711251 41.810038),60632-20210112
60633,01/26/2021,24,287,17,228,0.018,7,59,0.005,12689,POINT (-87.556037 41.653147),60633-20210126
60645,12/20/2020,11,144,11,144,0.003,0,0,0,47270,POINT (-87.695049 42.008927),60645-20201220
60637,01/08/2021,86,1104,36,972,0.021,50,132,0.003,47300,POINT (-87.604053 41.780991),60637-20210108
60647,12/20/2020,36,532,36,532,0.006,0,0,0,87633,POINT (-87.701101 41.921058),60647-20201220
60646,01/17/2021,22,1293,15,983,0.034,7,310,0.011,28569,POINT (-87.761826 41.993931),60646-20210117
60651,01/19/2021,35,806,17,667,0.011,18,139,0.002,63492,POINT (-87.741017 41.901964),60651-20210119
60608,12/25/2020,1,565,1,565,0.007,0,0,0,80059,POINT (-87.670366 41.849879),60608-20201225
60619,01/01/2021,0,267,0,267,0.004,0,0,0,61207,POINT (-87.60569 41.744737),60619-20210101
60827,01/17/2021,0,35,0,30,0.001,0,5,0,28483,POINT (-87.633087 41.650765),60827-20210117
Unknown,01/20/2021,73,517,49,438,0,24,79,0,0,,Unknown-20210120
60619,12/15/2020,0,0,0,0,0,0,0,0,61207,POINT (-87.60569 41.744737),60619-20201215
Unknown,01/14/2021,44,291,39,255,0,5,36,0,0,,Unknown-20210114
60601,12/16/2020,2,2,2,2,0,0,0,0,15083,POINT (-87.622844 41.886262),60601-20201216
60633,01/09/2021,1,97,1,86,0.007,0,11,0.001,12689,POINT (-87.556037 41.653147),60633-20210109
60616,01/02/2021,11,927,11,927,0.017,0,0,0,54197,POINT (-87.629531 41.844869),60616-20210102
60605,01/07/2021,220,2113,56,1853,0.064,164,260,0.009,29060,POINT (-87.623449 41.867824),60605-20210107
60628,01/14/2021,31,710,26,609,0.009,5,101,0.002,64254,POINT (-87.621537 41.694192),60628-20210114
60656,12/19/2020,37,105,37,105,0.004,0,0,0,28218,POINT (-87.817934 41.974566),60656-20201219
60827,12/16/2020,0,0,0,0,0,0,0,0,28483,POINT (-87.633087 41.650765),60827-20201216
60608,12/20/2020,19,244,19,244,0.003,0,0,0,80059,POINT (-87.670366 41.849879),60608-20201220
60639,01/10/2021,84,880,79,783,0.009,5,97,0.001,88204,POINT (-87.75531 41.920609),60639-20210110
60661,12/30/2020,32,438,32,438,0.042,0,0,0,10354,POINT (-87.644283 41.882786),60661-20201230
60607,01/07/2021,214,1983,92,1814,0.062,122,169,0.006,29293,POINT (-87.652727 41.876104),60607-20210107
60617,12/19/2020,15,72,15,72,0.001,0,0,0,83553,POINT (-87.556897 41.721257),60617-20201219
60642,12/23/2020,52,494,52,494,0.025,0,0,0,19716,POINT (-87.657821 41.899935),60642-20201223
60626,12/18/2020,76,101,76,101,0.002,0,0,0,50544,POINT (-87.669834 42.009469),60626-20201218
Unknown,01/03/2021,2,89,2,89,0,0,0,0,0,,Unknown-20210103
60608,01/06/2021,71,1170,58,1147,0.014,13,23,0,80059,POINT (-87.670366 41.849879),60608-20210106
60643,12/15/2020,0,0,0,0,0,0,0,0,48887,POINT (-87.662381 41.700445),60643-20201215
60617,01/01/2021,0,362,0,362,0.004,0,0,0,83553,POINT (-87.556897 41.721257),60617-20210101
60637,12/22/2020,79,256,79,256,0.005,0,0,0,47300,POINT (-87.604053 41.780991),60637-20201222
60660,01/02/2021,15,604,15,604,0.014,0,0,0,44498,POINT (-87.666362 41.991062),60660-20210102
60617,12/30/2020,52,343,52,343,0.004,0,0,0,83553,POINT (-87.556897 41.721257),60617-20201230
60612,12/18/2020,113,157,113,157,0.005,0,0,0,33735,POINT (-87.687011 41.88004),60612-20201218
60606,12/20/2020,3,52,3,52,0.016,0,0,0,3287,POINT (-87.63676 41.882634),60606-20201220
60639,12/24/2020,13,215,13,215,0.002,0,0,0,88204,POINT (-87.75531 41.920609),60639-20201224
60660,12/16/2020,2,2,2,2,0,0,0,0,44498,POINT (-87.666362 41.991062),60660-20201216
60661,12/15/2020,0,0,0,0,0,0,0,0,10354,POINT (-87.644283 41.882786),60661-20201215
60606,01/10/2021,3,205,0,156,0.047,3,49,0.015,3287,POINT (-87.63676 41.882634),60606-20210110
60602,12/22/2020,4,24,4,24,0.021,0,0,0,1145,POINT (-87.628309 41.883136),60602-20201222
60605,01/02/2021,18,1563,18,1563,0.054,0,0,0,29060,POINT (-87.623449 41.867824),60605-20210102
60646,12/16/2020,0,0,0,0,0,0,0,0,28569,POINT (-87.761826 41.993931),60646-20201216
60602,01/10/2021,2,79,1,64,0.056,1,15,0.013,1145,POINT (-87.628309 41.883136),60602-20210110
60618,01/02/2021,45,1455,45,1455,0.015,0,0,0,94907,POINT (-87.703343 41.946699),60618-20210102
60616,12/16/2020,3,3,3,3,0,0,0,0,54197,POINT (-87.629531 41.844869),60616-20201216
60609,01/08/2021,49,645,24,595,0.01,25,50,0.001,60939,POINT (-87.653382 41.812017),60609-20210108
60628,12/28/2020,31,143,31,143,0.002,0,0,0,64254,POINT (-87.621537 41.694192),60628-20201228
60626,12/29/2020,59,417,59,417,0.008,0,0,0,50544,POINT (-87.669834 42.009469),60626-20201229
60606,01/25/2021,21,394,15,266,0.081,6,128,0.039,3287,POINT (-87.63676 41.882634),60606-20210125
60638,12/31/2020,27,537,27,537,0.009,0,0,0,58669,POINT (-87.771902 41.787032),60638-20201231
60620,01/17/2021,4,895,3,758,0.011,1,137,0.002,67711,POINT (-87.651656 41.740873),60620-20210117
60623,01/06/2021,126,619,121,613,0.008,5,6,0,81283,POINT (-87.717446 41.850321),60623-20210106
60610,12/21/2020,133,479,133,479,0.012,0,0,0,40548,POINT (-87.63581 41.90455),60610-20201221
60607,12/23/2020,108,952,108,952,0.032,0,0,0,29293,POINT (-87.652727 41.876104),60607-20201223
60616,12/22/2020,106,536,106,536,0.01,0,0,0,54197,POINT (-87.629531 41.844869),60616-20201222
60643,01/04/2021,31,512,31,511,0.01,0,1,0,48887,POINT (-87.662381 41.700445),60643-20210104
60632,12/26/2020,6,160,6,160,0.002,0,0,0,89857,POINT (-87.711251 41.810038),60632-20201226
60629,12/25/2020,0,276,0,276,0.003,0,0,0,110029,POINT (-87.711565 41.777061),60629-20201225
60652,01/01/2021,0,381,0,381,0.009,0,0,0,43447,POINT (-87.714238 41.745398),60652-20210101
60621,12/21/2020,6,24,6,24,0.001,0,0,0,28018,POINT (-87.638812 41.776931),60621-20201221
60651,12/31/2020,18,234,18,234,0.004,0,0,0,63492,POINT (-87.741017 41.901964),60651-20201231
60827,12/26/2020,0,7,0,7,0,0,0,0,28483,POINT (-87.633087 41.650765),60827-20201226
60636,12/25/2020,0,29,0,29,0.001,0,0,0,30024,POINT (-87.668597 41.77599),60636-20201225
60608,12/15/2020,0,0,0,0,0,0,0,0,80059,POINT (-87.670366 41.849879),60608-20201215
60707,12/28/2020,6,81,6,81,0.002,0,0,0,43093,POINT (-87.808283 41.921777),60707-20201228
60652,12/19/2020,11,51,11,51,0.001,0,0,0,43447,POINT (-87.714238 41.745398),60652-20201219
60618,01/12/2021,246,3076,127,2338,0.025,119,738,0.008,94907,POINT (-87.703343 41.946699),60618-20210112
60619,12/25/2020,0,121,0,121,0.002,0,0,0,61207,POINT (-87.60569 41.744737),60619-20201225
60605,01/17/2021,29,3497,15,2276,0.078,14,1221,0.042,29060,POINT (-87.623449 41.867824),60605-20210117
60610,01/16/2021,61,2293,50,1637,0.04,11,656,0.016,40548,POINT (-87.63581 41.90455),60610-20210116
60623,12/30/2020,54,353,54,353,0.004,0,0,0,81283,POINT (-87.717446 41.850321),60623-20201230
60656,01/03/2021,3,303,3,303,0.011,0,0,0,28218,POINT (-87.817934 41.974566),60656-20210103
60640,01/14/2021,181,3735,156,3072,0.044,25,663,0.01,69363,POINT (-87.662232 41.971888),60640-20210114
60621,12/30/2020,71,177,71,177,0.006,0,0,0,28018,POINT (-87.638812 41.776931),60621-20201230
60642,01/24/2021,22,2076,21,1415,0.072,1,661,0.034,19716,POINT (-87.657821 41.899935),60642-20210124
60614,01/04/2021,98,1980,86,1968,0.027,12,12,0,71954,POINT (-87.652064 41.922605),60614-20210104
60646,01/07/2021,70,689,32,645,0.023,38,44,0.002,28569,POINT (-87.761826 41.993931),60646-20210107
60657,01/02/2021,64,2122,64,2122,0.03,0,0,0,70958,POINT (-87.658216 41.939715),60657-20210102
60619,12/20/2020,4,49,4,49,0.001,0,0,0,61207,POINT (-87.60569 41.744737),60619-20201220
60642,01/05/2021,59,814,52,803,0.041,7,11,0.001,19716,POINT (-87.657821 41.899935),60642-20210105
60660,01/17/2021,27,2321,20,1979,0.044,7,342,0.008,44498,POINT (-87.666362 41.991062),60660-20210117
60643,12/28/2020,17,330,17,330,0.007,0,0,0,48887,POINT (-87.662381 41.700445),60643-20201228
60633,12/25/2020,0,26,0,26,0.002,0,0,0,12689,POINT (-87.556037 41.653147),60633-20201225
60657,12/16/2020,10,10,10,10,0,0,0,0,70958,POINT (-87.658216 41.939715),60657-20201216
60608,12/30/2020,141,843,141,843,0.011,0,0,0,80059,POINT (-87.670366 41.849879),60608-20201230
60612,01/08/2021,143,1239,48,1074,0.032,95,165,0.005,33735,POINT (-87.687011 41.88004),60612-20210108
60651,12/18/2020,28,33,28,33,0.001,0,0,0,63492,POINT (-87.741017 41.901964),60651-20201218
60610,01/12/2021,134,1961,55,1399,0.035,79,562,0.014,40548,POINT (-87.63581 41.90455),60610-20210112
60625,12/26/2020,16,639,16,639,0.008,0,0,0,79444,POINT (-87.701816 41.971155),60625-20201226
60625,01/02/2021,32,1018,32,1018,0.013,0,0,0,79444,POINT (-87.701816 41.971155),60625-20210102
60628,01/18/2021,39,809,30,694,0.011,9,115,0.002,64254,POINT (-87.621537 41.694192),60628-20210118
60632,01/16/2021,52,1050,45,902,0.01,7,148,0.002,89857,POINT (-87.711251 41.810038),60632-20210116
60645,12/24/2020,11,280,11,280,0.006,0,0,0,47270,POINT (-87.695049 42.008927),60645-20201224
60644,01/11/2021,15,664,7,632,0.014,8,32,0.001,46591,POINT (-87.756863 41.881113),60644-20210111
60646,01/25/2021,106,2127,80,1687,0.059,26,440,0.015,28569,POINT (-87.761826 41.993931),60646-20210125
60661,12/25/2020,0,351,0,351,0.034,0,0,0,10354,POINT (-87.644283 41.882786),60661-20201225
60628,12/17/2020,7,7,7,7,0,0,0,0,64254,POINT (-87.621537 41.694192),60628-20201217
60609,12/29/2020,37,242,37,242,0.004,0,0,0,60939,POINT (-87.653382 41.812017),60609-20201229
60647,12/30/2020,124,1279,124,1279,0.015,0,0,0,87633,POINT (-87.701101 41.921058),60647-20201230
60606,01/16/2021,7,275,5,185,0.056,2,90,0.027,3287,POINT (-87.63676 41.882634),60606-20210116
60827,12/31/2020,0,9,0,9,0,0,0,0,28483,POINT (-87.633087 41.650765),60827-20201231
60623,12/17/2020,10,12,10,12,0,0,0,0,81283,POINT (-87.717446 41.850321),60623-20201217
60608,01/11/2021,120,1840,34,1512,0.019,86,328,0.004,80059,POINT (-87.670366 41.849879),60608-20210111
60661,12/18/2020,88,136,88,136,0.013,0,0,0,10354,POINT (-87.644283 41.882786),60661-20201218
60617,12/25/2020,0,199,0,199,0.002,0,0,0,83553,POINT (-87.556897 41.721257),60617-20201225
60656,12/15/2020,0,0,0,0,0,0,0,0,28218,POINT (-87.817934 41.974566),60656-20201215
60666,02/01/2021,1,10,1,10,0,0,0,0,0,POINT (-87.896371 41.979511),60666-20210201
60628,01/12/2021,43,624,29,549,0.009,14,75,0.001,64254,POINT (-87.621537 41.694192),60628-20210112
60620,01/03/2021,8,270,7,269,0.004,1,1,0,67711,POINT (-87.651656 41.740873),60620-20210103
60653,01/01/2021,0,398,0,398,0.012,0,0,0,33154,POINT (-87.611244 41.819261),60653-20210101
60632,12/15/2020,0,0,0,0,0,0,0,0,89857,POINT (-87.711251 41.810038),60632-20201215
60628,12/22/2020,17,81,17,81,0.001,0,0,0,64254,POINT (-87.621537 41.694192),60628-20201222
60609,12/24/2020,7,179,7,179,0.003,0,0,0,60939,POINT (-87.653382 41.812017),60609-20201224
60618,12/23/2020,112,876,112,876,0.009,0,0,0,94907,POINT (-87.703343 41.946699),60618-20201223
60631,12/15/2020,0,0,0,0,0,0,0,0,29529,POINT (-87.813371 41.995019),60631-20201215
60605,01/11/2021,224,2858,39,1985,0.068,185,873,0.03,29060,POINT (-87.623449 41.867824),60605-20210111
60614,01/07/2021,229,2496,45,2265,0.031,184,231,0.003,71954,POINT (-87.652064 41.922605),60614-20210107
60616,01/06/2021,73,1248,44,1197,0.022,29,51,0.001,54197,POINT (-87.629531 41.844869),60616-20210106
60640,01/07/2021,156,2080,86,1974,0.028,70,106,0.002,69363,POINT (-87.662232 41.971888),60640-20210107
60640,01/09/2021,128,2694,53,2375,0.034,75,319,0.005,69363,POINT (-87.662232 41.971888),60640-20210109
Unknown,01/31/2021,2,941,2,806,0,0,135,0,0,,Unknown-20210131
Unknown,12/30/2020,24,83,24,83,0,0,0,0,0,,Unknown-20201230
60617,12/15/2020,0,0,0,0,0,0,0,0,83553,POINT (-87.556897 41.721257),60617-20201215
60636,12/28/2020,10,41,10,41,0.001,0,0,0,30024,POINT (-87.668597 41.77599),60636-20201228
60666,12/29/2020,0,0,0,0,0,0,0,0,0,POINT (-87.896371 41.979511),60666-20201229
60639,01/14/2021,80,1233,67,1034,0.012,13,199,0.002,88204,POINT (-87.75531 41.920609),60639-20210114
60620,12/19/2020,12,65,12,65,0.001,0,0,0,67711,POINT (-87.651656 41.740873),60620-20201219
60640,12/17/2020,39,42,39,42,0.001,0,0,0,69363,POINT (-87.662232 41.971888),60640-20201217
60617,01/05/2021,59,469,57,464,0.006,2,5,0,83553,POINT (-87.556897 41.721257),60617-20210105
60631,12/20/2020,24,206,24,206,0.007,0,0,0,29529,POINT (-87.813371 41.995019),60631-20201220
60644,01/22/2021,77,1205,74,1084,0.023,3,121,0.003,46591,POINT (-87.756863 41.881113),60644-20210122
60633,01/05/2021,9,68,9,68,0.005,0,0,0,12689,POINT (-87.556037 41.653147),60633-20210105
60651,01/06/2021,27,364,25,360,0.006,2,4,0,63492,POINT (-87.741017 41.901964),60651-20210106
60610,12/16/2020,2,2,2,2,0,0,0,0,40548,POINT (-87.63581 41.90455),60610-20201216
60607,01/03/2021,14,1447,13,1446,0.049,1,1,0,29293,POINT (-87.652727 41.876104),60607-20210103
60612,12/22/2020,86,411,86,411,0.012,0,0,0,33735,POINT (-87.687011 41.88004),60612-20201222
60609,01/03/2021,4,344,4,344,0.006,0,0,0,60939,POINT (-87.653382 41.812017),60609-20210103
60602,12/26/2020,0,30,0,30,0.026,0,0,0,1145,POINT (-87.628309 41.883136),60602-20201226
60618,01/07/2021,185,2097,79,1955,0.021,106,142,0.001,94907,POINT (-87.703343 41.946699),60618-20210107
60605,12/19/2020,163,564,163,564,0.019,0,0,0,29060,POINT (-87.623449 41.867824),60605-20201219
60622,01/04/2021,103,2244,90,2230,0.042,13,14,0,53294,POINT (-87.681818 41.902762),60622-20210104
60633,12/21/2020,4,14,4,14,0.001,0,0,0,12689,POINT (-87.556037 41.653147),60633-20201221
60660,12/19/2020,52,175,52,175,0.004,0,0,0,44498,POINT (-87.666362 41.991062),60660-20201219
60606,01/06/2021,4,150,1,141,0.043,3,9,0.003,3287,POINT (-87.63676 41.882634),60606-20210106
60657,01/06/2021,146,2701,97,2629,0.037,49,72,0.001,70958,POINT (-87.658216 41.939715),60657-20210106
60666,01/13/2021,1,1,1,1,0,0,0,0,0,POINT (-87.896371 41.979511),60666-20210113
60647,01/04/2021,80,1484,74,1478,0.017,6,6,0,87633,POINT (-87.701101 41.921058),60647-20210104
60616,12/18/2020,158,221,158,221,0.004,0,0,0,54197,POINT (-87.629531 41.844869),60616-20201218
60606,01/21/2021,23,339,18,220,0.067,5,119,0.036,3287,POINT (-87.63676 41.882634),60606-20210121
60602,01/06/2021,3,61,3,60,0.052,0,1,0.001,1145,POINT (-87.628309 41.883136),60602-20210106
60649,01/05/2021,33,373,31,369,0.008,2,4,0,46633,POINT (-87.571522 41.762202),60649-20210105
60628,01/01/2021,0,231,0,231,0.004,0,0,0,64254,POINT (-87.621537 41.694192),60628-20210101
60641,12/27/2020,0,441,0,441,0.006,0,0,0,69880,POINT (-87.746791 41.946682),60641-20201227
60655,12/28/2020,18,395,18,395,0.014,0,0,0,28569,POINT (-87.701434 41.696456),60655-20201228
60666,01/15/2021,0,1,0,1,0,0,0,0,0,POINT (-87.896371 41.979511),60666-20210115
60607,12/19/2020,161,510,161,510,0.017,0,0,0,29293,POINT (-87.652727 41.876104),60607-20201219
60620,12/24/2020,10,132,10,132,0.002,0,0,0,67711,POINT (-87.651656 41.740873),60620-20201224
60646,12/21/2020,55,222,55,222,0.008,0,0,0,28569,POINT (-87.761826 41.993931),60646-20201221
60666,01/21/2021,0,2,0,2,0,0,0,0,0,POINT (-87.896371 41.979511),60666-20210121
60623,01/18/2021,38,1172,23,1016,0.012,15,156,0.002,81283,POINT (-87.717446 41.850321),60623-20210118
60606,12/24/2020,2,90,2,90,0.027,0,0,0,3287,POINT (-87.63676 41.882634),60606-20201224
60629,12/31/2020,27,522,27,522,0.005,0,0,0,110029,POINT (-87.711565 41.777061),60629-20201231
60630,12/28/2020,34,467,34,467,0.008,0,0,0,56433,POINT (-87.759611 41.971261),60630-20201228
60613,12/24/2020,37,802,37,802,0.016,0,0,0,50761,POINT (-87.661343 41.953742),60613-20201224
60827,02/01/2021,1,82,0,69,0.002,1,13,0,28483,POINT (-87.633087 41.650765),60827-20210201
60632,12/30/2020,130,372,130,372,0.004,0,0,0,89857,POINT (-87.711251 41.810038),60632-20201230
60640,01/01/2021,2,1158,2,1158,0.017,0,0,0,69363,POINT (-87.662232 41.971888),60640-20210101
60642,01/02/2021,10,703,10,703,0.036,0,0,0,19716,POINT (-87.657821 41.899935),60642-20210102
60666,12/31/2020,0,0,0,0,0,0,0,0,0,POINT (-87.896371 41.979511),60666-20201231
60645,01/04/2021,157,823,155,821,0.017,2,2,0,47270,POINT (-87.695049 42.008927),60645-20210104
60643,12/24/2020,10,311,10,311,0.006,0,0,0,48887,POINT (-87.662381 41.700445),60643-20201224
60646,01/22/2021,128,1815,118,1412,0.049,10,403,0.014,28569,POINT (-87.761826 41.993931),60646-20210122
60661,01/16/2021,22,1055,17,716,0.069,5,339,0.033,10354,POINT (-87.644283 41.882786),60661-20210116
60656,12/30/2020,26,269,26,269,0.01,0,0,0,28218,POINT (-87.817934 41.974566),60656-20201230
60637,01/03/2021,84,710,79,705,0.015,5,5,0,47300,POINT (-87.604053 41.780991),60637-20210103
60653,12/18/2020,27,37,27,37,0.001,0,0,0,33154,POINT (-87.611244 41.819261),60653-20201218
60651,12/16/2020,0,0,0,0,0,0,0,0,63492,POINT (-87.741017 41.901964),60651-20201216
60827,01/27/2021,5,59,4,51,0.002,1,8,0,28483,POINT (-87.633087 41.650765),60827-20210127
60624,12/19/2020,5,23,5,23,0.001,0,0,0,34892,POINT (-87.722735 41.879417),60624-20201219
60638,12/27/2020,0,327,0,327,0.006,0,0,0,58669,POINT (-87.771902 41.787032),60638-20201227
60644,12/21/2020,17,47,17,47,0.001,0,0,0,46591,POINT (-87.756863 41.881113),60644-20201221
60629,01/01/2021,0,522,0,522,0.005,0,0,0,110029,POINT (-87.711565 41.777061),60629-20210101
60640,12/27/2020,0,708,0,708,0.01,0,0,0,69363,POINT (-87.662232 41.971888),60640-20201227
60630,01/02/2021,23,672,23,672,0.012,0,0,0,56433,POINT (-87.759611 41.971261),60630-20210102
60653,01/04/2021,17,427,16,426,0.013,1,1,0,33154,POINT (-87.611244 41.819261),60653-20210104
60645,01/11/2021,70,1378,26,1191,0.025,44,187,0.004,47270,POINT (-87.695049 42.008927),60645-20210111
60609,12/19/2020,19,60,19,60,0.001,0,0,0,60939,POINT (-87.653382 41.812017),60609-20201219
60621,01/03/2021,0,180,0,180,0.006,0,0,0,28018,POINT (-87.638812 41.776931),60621-20210103
60607,12/29/2020,117,1177,117,1177,0.04,0,0,0,29293,POINT (-87.652727 41.876104),60607-20201229
60614,12/23/2020,100,1251,100,1251,0.017,0,0,0,71954,POINT (-87.652064 41.922605),60614-20201223
60827,01/14/2021,3,30,2,25,0.001,1,5,0,28483,POINT (-87.633087 41.650765),60827-20210114
60602,12/15/2020,0,0,0,0,0,0,0,0,1145,POINT (-87.628309 41.883136),60602-20201215
60657,12/20/2020,44,760,44,760,0.011,0,0,0,70958,POINT (-87.658216 41.939715),60657-20201220
60620,12/29/2020,32,191,32,191,0.003,0,0,0,67711,POINT (-87.651656 41.740873),60620-20201229
60639,01/04/2021,65,475,62,472,0.005,3,3,0,88204,POINT (-87.75531 41.920609),60639-20210104
60619,01/06/2021,42,391,39,384,0.006,3,7,0,61207,POINT (-87.60569 41.744737),60619-20210106
60660,01/05/2021,77,799,76,794,0.018,1,5,0,44498,POINT (-87.666362 41.991062),60660-20210105
60601,12/17/2020,29,31,29,31,0.002,0,0,0,15083,POINT (-87.622844 41.886262),60601-20201217
60601,12/18/2020,65,96,65,96,0.006,0,0,0,15083,POINT (-87.622844 41.886262),60601-20201218
60601,12/19/2020,43,139,43,139,0.009,0,0,0,15083,POINT (-87.622844 41.886262),60601-20201219
60601,12/20/2020,9,148,9,148,0.01,0,0,0,15083,POINT (-87.622844 41.886262),60601-20201220
60601,12/21/2020,72,220,72,220,0.015,0,0,0,15083,POINT (-87.622844 41.886262),60601-20201221
60601,12/22/2020,48,268,48,268,0.018,0,0,0,15083,POINT (-87.622844 41.886262),60601-20201222
60601,12/23/2020,29,297,29,297,0.02,0,0,0,15083,POINT (-87.622844 41.886262),60601-20201223
60602,01/15/2021,7,110,7,80,0.07,0,30,0.026,1145,POINT (-87.628309 41.883136),60602-20210115
60603,12/15/2020,0,0,0,0,0,0,0,0,1052,POINT (-87.625473 41.880112),60603-20201215
60603,12/16/2020,0,0,0,0,0,0,0,0,1052,POINT (-87.625473 41.880112),60603-20201216
60603,12/17/2020,8,8,8,8,0.008,0,0,0,1052,POINT (-87.625473 41.880112),60603-20201217
60603,12/18/2020,6,14,6,14,0.013,0,0,0,1052,POINT (-87.625473 41.880112),60603-20201218
60603,12/19/2020,4,18,4,18,0.017,0,0,0,1052,POINT (-87.625473 41.880112),60603-20201219
60603,12/20/2020,5,23,5,23,0.022,0,0,0,1052,POINT (-87.625473 41.880112),60603-20201220
60603,12/21/2020,5,28,5,28,0.027,0,0,0,1052,POINT (-87.625473 41.880112),60603-20201221
60603,12/22/2020,7,35,7,35,0.033,0,0,0,1052,POINT (-87.625473 41.880112),60603-20201222
60603,12/23/2020,0,35,0,35,0.033,0,0,0,1052,POINT (-87.625473 41.880112),60603-20201223
60603,12/24/2020,1,36,1,36,0.034,0,0,0,1052,POINT (-87.625473 41.880112),60603-20201224
60603,12/25/2020,0,36,0,36,0.034,0,0,0,1052,POINT (-87.625473 41.880112),60603-20201225
60603,12/26/2020,0,36,0,36,0.034,0,0,0,1052,POINT (-87.625473 41.880112),60603-20201226
60603,12/27/2020,0,36,0,36,0.034,0,0,0,1052,POINT (-87.625473 41.880112),60603-20201227
60603,12/28/2020,1,37,1,37,0.035,0,0,0,1052,POINT (-87.625473 41.880112),60603-20201228
60603,12/29/2020,2,39,2,39,0.037,0,0,0,1052,POINT (-87.625473 41.880112),60603-20201229
60603,12/30/2020,3,42,3,42,0.04,0,0,0,1052,POINT (-87.625473 41.880112),60603-20201230
60603,12/31/2020,1,43,1,43,0.041,0,0,0,1052,POINT (-87.625473 41.880112),60603-20201231
60603,01/01/2021,0,43,0,43,0.041,0,0,0,1052,POINT (-87.625473 41.880112),60603-20210101
60603,01/02/2021,0,43,0,43,0.041,0,0,0,1052,POINT (-87.625473 41.880112),60603-20210102
60603,01/03/2021,0,43,0,43,0.041,0,0,0,1052,POINT (-87.625473 41.880112),60603-20210103
60603,01/04/2021,2,45,2,45,0.043,0,0,0,1052,POINT (-87.625473 41.880112),60603-20210104
60603,01/05/2021,3,48,2,47,0.045,1,1,0.001,1052,POINT (-87.625473 41.880112),60603-20210105
60603,01/06/2021,1,49,1,48,0.046,0,1,0.001,1052,POINT (-87.625473 41.880112),60603-20210106
60603,01/07/2021,11,60,1,49,0.047,10,11,0.01,1052,POINT (-87.625473 41.880112),60603-20210107
60603,01/08/2021,9,69,2,51,0.048,7,18,0.017,1052,POINT (-87.625473 41.880112),60603-20210108
60603,01/09/2021,42,111,37,88,0.084,5,23,0.022,1052,POINT (-87.625473 41.880112),60603-20210109
60603,01/10/2021,3,114,1,89,0.085,2,25,0.024,1052,POINT (-87.625473 41.880112),60603-20210110
60603,01/11/2021,1,115,0,89,0.085,1,26,0.025,1052,POINT (-87.625473 41.880112),60603-20210111
60603,01/12/2021,7,122,1,90,0.086,6,32,0.03,1052,POINT (-87.625473 41.880112),60603-20210112
60603,01/13/2021,2,124,2,92,0.087,0,32,0.03,1052,POINT (-87.625473 41.880112),60603-20210113
60603,01/14/2021,5,129,4,96,0.091,1,33,0.031,1052,POINT (-87.625473 41.880112),60603-20210114
60603,01/15/2021,11,140,11,107,0.102,0,33,0.031,1052,POINT (-87.625473 41.880112),60603-20210115
60603,01/16/2021,35,175,35,142,0.135,0,33,0.031,1052,POINT (-87.625473 41.880112),60603-20210116
60603,01/17/2021,2,177,2,144,0.137,0,33,0.031,1052,POINT (-87.625473 41.880112),60603-20210117
60604,12/15/2020,0,0,0,0,0,0,0,0,823,POINT (-87.629029 41.878153),60604-20201215
60604,12/16/2020,0,0,0,0,0,0,0,0,823,POINT (-87.629029 41.878153),60604-20201216
60604,12/17/2020,0,0,0,0,0,0,0,0,823,POINT (-87.629029 41.878153),60604-20201217
60604,12/18/2020,5,5,5,5,0.006,0,0,0,823,POINT (-87.629029 41.878153),60604-20201218
60604,12/19/2020,0,5,0,5,0.006,0,0,0,823,POINT (-87.629029 41.878153),60604-20201219
60604,12/20/2020,0,5,0,5,0.006,0,0,0,823,POINT (-87.629029 41.878153),60604-20201220
60604,12/21/2020,0,5,0,5,0.006,0,0,0,823,POINT (-87.629029 41.878153),60604-20201221
60604,12/22/2020,0,5,0,5,0.006,0,0,0,823,POINT (-87.629029 41.878153),60604-20201222
60604,12/23/2020,1,6,1,6,0.007,0,0,0,823,POINT (-87.629029 41.878153),60604-20201223
60604,12/24/2020,1,7,1,7,0.009,0,0,0,823,POINT (-87.629029 41.878153),60604-20201224
60604,12/25/2020,0,7,0,7,0.009,0,0,0,823,POINT (-87.629029 41.878153),60604-20201225
60604,12/26/2020,0,7,0,7,0.009,0,0,0,823,POINT (-87.629029 41.878153),60604-20201226
60604,12/27/2020,0,7,0,7,0.009,0,0,0,823,POINT (-87.629029 41.878153),60604-20201227
60604,12/28/2020,1,8,1,8,0.01,0,0,0,823,POINT (-87.629029 41.878153),60604-20201228
60604,12/29/2020,1,9,1,9,0.011,0,0,0,823,POINT (-87.629029 41.878153),60604-20201229
60604,12/30/2020,1,10,1,10,0.012,0,0,0,823,POINT (-87.629029 41.878153),60604-20201230
60604,12/31/2020,1,11,1,11,0.013,0,0,0,823,POINT (-87.629029 41.878153),60604-20201231
60604,01/01/2021,0,11,0,11,0.013,0,0,0,823,POINT (-87.629029 41.878153),60604-20210101
60604,01/02/2021,0,11,0,11,0.013,0,0,0,823,POINT (-87.629029 41.878153),60604-20210102
60604,01/03/2021,0,11,0,11,0.013,0,0,0,823,POINT (-87.629029 41.878153),60604-20210103
60604,01/04/2021,1,12,1,12,0.015,0,0,0,823,POINT (-87.629029 41.878153),60604-20210104
60604,01/05/2021,2,14,2,14,0.017,0,0,0,823,POINT (-87.629029 41.878153),60604-20210105
60604,01/06/2021,1,15,1,15,0.018,0,0,0,823,POINT (-87.629029 41.878153),60604-20210106
60604,01/07/2021,3,18,1,16,0.019,2,2,0.002,823,POINT (-87.629029 41.878153),60604-20210107
60604,01/08/2021,4,22,2,18,0.022,2,4,0.005,823,POINT (-87.629029 41.878153),60604-20210108
60604,01/09/2021,2,24,1,19,0.023,1,5,0.006,823,POINT (-87.629029 41.878153),60604-20210109
60604,01/10/2021,0,24,0,19,0.023,0,5,0.006,823,POINT (-87.629029 41.878153),60604-20210110
60604,01/11/2021,1,25,1,20,0.024,0,5,0.006,823,POINT (-87.629029 41.878153),60604-20210111
60604,01/12/2021,0,25,0,20,0.024,0,5,0.006,823,POINT (-87.629029 41.878153),60604-20210112
60604,01/13/2021,10,35,9,29,0.035,1,6,0.007,823,POINT (-87.629029 41.878153),60604-20210113
60604,01/14/2021,4,39,3,32,0.039,1,7,0.009,823,POINT (-87.629029 41.878153),60604-20210114
60604,01/15/2021,3,42,3,35,0.043,0,7,0.009,823,POINT (-87.629029 41.878153),60604-20210115
60604,01/16/2021,2,44,2,37,0.045,0,7,0.009,823,POINT (-87.629029 41.878153),60604-20210116
60604,01/17/2021,3,47,3,40,0.049,0,7,0.009,823,POINT (-87.629029 41.878153),60604-20210117
60604,01/18/2021,0,47,0,40,0.049,0,7,0.009,823,POINT (-87.629029 41.878153),60604-20210118
60604,01/19/2021,9,56,7,47,0.057,2,9,0.011,823,POINT (-87.629029 41.878153),60604-20210119
60604,01/20/2021,3,59,3,50,0.061,0,9,0.011,823,POINT (-87.629029 41.878153),60604-20210120
60604,01/21/2021,9,68,7,57,0.069,2,11,0.013,823,POINT (-87.629029 41.878153),60604-20210121
60604,01/22/2021,8,76,8,65,0.079,0,11,0.013,823,POINT (-87.629029 41.878153),60604-20210122
60604,01/23/2021,5,81,5,70,0.085,0,11,0.013,823,POINT (-87.629029 41.878153),60604-20210123
60604,01/24/2021,2,83,2,72,0.087,0,11,0.013,823,POINT (-87.629029 41.878153),60604-20210124
60604,01/25/2021,20,103,20,92,0.112,0,11,0.013,823,POINT (-87.629029 41.878153),60604-20210125
60607,01/09/2021,168,2427,29,1914,0.065,139,513,0.018,29293,POINT (-87.652727 41.876104),60607-20210109
60607,01/10/2021,30,2457,8,1922,0.066,22,535,0.018,29293,POINT (-87.652727 41.876104),60607-20210110
60607,01/11/2021,148,2605,28,1950,0.067,120,655,0.022,29293,POINT (-87.652727 41.876104),60607-20210111
60607,01/12/2021,223,2828,74,2024,0.069,149,804,0.027,29293,POINT (-87.652727 41.876104),60607-20210112
60607,01/13/2021,194,3022,83,2107,0.072,111,915,0.031,29293,POINT (-87.652727 41.876104),60607-20210113
60607,01/14/2021,112,3134,79,2186,0.075,33,948,0.032,29293,POINT (-87.652727 41.876104),60607-20210114
60607,01/15/2021,88,3222,74,2260,0.077,14,962,0.033,29293,POINT (-87.652727 41.876104),60607-20210115
60607,01/16/2021,51,3273,36,2296,0.078,15,977,0.033,29293,POINT (-87.652727 41.876104),60607-20210116
60607,01/17/2021,13,3286,9,2305,0.079,4,981,0.033,29293,POINT (-87.652727 41.876104),60607-20210117
60611,12/17/2020,172,186,172,186,0.006,0,0,0,33224,POINT (-87.620291 41.894734),60611-20201217
60611,12/18/2020,515,701,515,701,0.021,0,0,0,33224,POINT (-87.620291 41.894734),60611-20201218
60611,12/19/2020,191,892,191,892,0.027,0,0,0,33224,POINT (-87.620291 41.894734),60611-20201219
60611,12/20/2020,20,912,20,912,0.027,0,0,0,33224,POINT (-87.620291 41.894734),60611-20201220
60611,12/21/2020,422,1334,422,1334,0.04,0,0,0,33224,POINT (-87.620291 41.894734),60611-20201221
60611,12/22/2020,182,1516,182,1516,0.046,0,0,0,33224,POINT (-87.620291 41.894734),60611-20201222
60611,12/23/2020,67,1583,67,1583,0.048,0,0,0,33224,POINT (-87.620291 41.894734),60611-20201223
60611,12/24/2020,27,1610,27,1610,0.048,0,0,0,33224,POINT (-87.620291 41.894734),60611-20201224
60611,12/25/2020,0,1610,0,1610,0.048,0,0,0,33224,POINT (-87.620291 41.894734),60611-20201225
60611,12/26/2020,38,1648,38,1648,0.05,0,0,0,33224,POINT (-87.620291 41.894734),60611-20201226
60611,12/27/2020,0,1648,0,1648,0.05,0,0,0,33224,POINT (-87.620291 41.894734),60611-20201227
60611,12/28/2020,127,1775,127,1775,0.053,0,0,0,33224,POINT (-87.620291 41.894734),60611-20201228
60611,12/29/2020,120,1895,120,1895,0.057,0,0,0,33224,POINT (-87.620291 41.894734),60611-20201229
60611,12/30/2020,87,1982,87,1982,0.06,0,0,0,33224,POINT (-87.620291 41.894734),60611-20201230
60611,12/31/2020,26,2008,26,2008,0.06,0,0,0,33224,POINT (-87.620291 41.894734),60611-20201231
60611,01/01/2021,3,2011,3,2011,0.061,0,0,0,33224,POINT (-87.620291 41.894734),60611-20210101
60611,01/02/2021,32,2043,32,2043,0.061,0,0,0,33224,POINT (-87.620291 41.894734),60611-20210102
60611,01/03/2021,23,2066,23,2066,0.062,0,0,0,33224,POINT (-87.620291 41.894734),60611-20210103
60611,01/04/2021,53,2119,45,2111,0.064,8,8,0,33224,POINT (-87.620291 41.894734),60611-20210104
60611,01/05/2021,210,2329,192,2303,0.069,18,26,0.001,33224,POINT (-87.620291 41.894734),60611-20210105
60611,01/06/2021,73,2402,44,2347,0.071,29,55,0.002,33224,POINT (-87.620291 41.894734),60611-20210106
60611,01/07/2021,222,2624,39,2386,0.072,183,238,0.007,33224,POINT (-87.620291 41.894734),60611-20210107
60611,01/08/2021,957,3581,438,2824,0.085,519,757,0.023,33224,POINT (-87.620291 41.894734),60611-20210108
60611,01/09/2021,212,3793,51,2875,0.087,161,918,0.028,33224,POINT (-87.620291 41.894734),60611-20210109
60611,01/10/2021,47,3840,11,2886,0.087,36,954,0.029,33224,POINT (-87.620291 41.894734),60611-20210110
60611,01/11/2021,437,4277,76,2962,0.089,361,1315,0.04,33224,POINT (-87.620291 41.894734),60611-20210111
60611,01/12/2021,260,4537,86,3048,0.092,174,1489,0.045,33224,POINT (-87.620291 41.894734),60611-20210112
60611,01/13/2021,148,4685,67,3115,0.094,81,1570,0.047,33224,POINT (-87.620291 41.894734),60611-20210113
60611,01/14/2021,100,4785,63,3178,0.096,37,1607,0.048,33224,POINT (-87.620291 41.894734),60611-20210114
60611,01/15/2021,81,4866,67,3245,0.098,14,1621,0.049,33224,POINT (-87.620291 41.894734),60611-20210115
60612,01/16/2021,29,1921,28,1413,0.042,1,508,0.015,33735,POINT (-87.687011 41.88004),60612-20210116
60612,01/09/2021,56,1295,16,1090,0.032,40,205,0.006,33735,POINT (-87.687011 41.88004),60612-20210109
60612,01/10/2021,13,1308,6,1096,0.032,7,212,0.006,33735,POINT (-87.687011 41.88004),60612-20210110
60612,01/11/2021,119,1427,25,1121,0.033,94,306,0.009,33735,POINT (-87.687011 41.88004),60612-20210111
60612,01/12/2021,136,1563,62,1183,0.035,74,380,0.011,33735,POINT (-87.687011 41.88004),60612-20210112
60612,01/13/2021,128,1691,55,1238,0.037,73,453,0.013,33735,POINT (-87.687011 41.88004),60612-20210113
60612,01/14/2021,100,1791,65,1303,0.039,35,488,0.014,33735,POINT (-87.687011 41.88004),60612-20210114
60612,01/15/2021,101,1892,82,1385,0.041,19,507,0.015,33735,POINT (-87.687011 41.88004),60612-20210115
60612,01/17/2021,7,1928,3,1416,0.042,4,512,0.015,33735,POINT (-87.687011 41.88004),60612-20210117
60613,01/11/2021,274,2424,140,1871,0.037,134,553,0.011,50761,POINT (-87.661343 41.953742),60613-20210111
60613,12/28/2020,79,900,79,900,0.018,0,0,0,50761,POINT (-87.661343 41.953742),60613-20201228
60613,12/29/2020,142,1042,142,1042,0.021,0,0,0,50761,POINT (-87.661343 41.953742),60613-20201229
60613,12/30/2020,128,1170,128,1170,0.023,0,0,0,50761,POINT (-87.661343 41.953742),60613-20201230
60613,12/31/2020,34,1204,34,1204,0.024,0,0,0,50761,POINT (-87.661343 41.953742),60613-20201231
60613,01/01/2021,0,1204,0,1204,0.024,0,0,0,50761,POINT (-87.661343 41.953742),60613-20210101
60613,01/02/2021,31,1235,31,1235,0.024,0,0,0,50761,POINT (-87.661343 41.953742),60613-20210102
60613,01/03/2021,21,1256,21,1256,0.025,0,0,0,50761,POINT (-87.661343 41.953742),60613-20210103
60613,01/04/2021,89,1345,80,1336,0.026,9,9,0,50761,POINT (-87.661343 41.953742),60613-20210104
60613,01/05/2021,141,1486,134,1470,0.029,7,16,0,50761,POINT (-87.661343 41.953742),60613-20210105
60613,01/06/2021,81,1567,60,1530,0.03,21,37,0.001,50761,POINT (-87.661343 41.953742),60613-20210106
60613,01/07/2021,147,1714,67,1597,0.031,80,117,0.002,50761,POINT (-87.661343 41.953742),60613-20210107
60613,01/08/2021,265,1979,75,1672,0.033,190,307,0.006,50761,POINT (-87.661343 41.953742),60613-20210108
60613,01/09/2021,137,2116,45,1717,0.034,92,399,0.008,50761,POINT (-87.661343 41.953742),60613-20210109
60613,01/10/2021,34,2150,14,1731,0.034,20,419,0.008,50761,POINT (-87.661343 41.953742),60613-20210110
60613,01/12/2021,358,2782,249,2120,0.042,109,662,0.013,50761,POINT (-87.661343 41.953742),60613-20210112
60613,01/13/2021,172,2954,87,2207,0.043,85,747,0.015,50761,POINT (-87.661343 41.953742),60613-20210113
60613,01/14/2021,127,3081,102,2309,0.045,25,772,0.015,50761,POINT (-87.661343 41.953742),60613-20210114
60613,01/15/2021,101,3182,85,2394,0.047,16,788,0.016,50761,POINT (-87.661343 41.953742),60613-20210115
60614,01/09/2021,192,3088,52,2409,0.033,140,679,0.009,71954,POINT (-87.652064 41.922605),60614-20210109
60614,01/10/2021,72,3160,31,2440,0.034,41,720,0.01,71954,POINT (-87.652064 41.922605),60614-20210110
60614,01/11/2021,351,3511,125,2565,0.036,226,946,0.013,71954,POINT (-87.652064 41.922605),60614-20210111
60614,01/12/2021,319,3830,145,2710,0.038,174,1120,0.016,71954,POINT (-87.652064 41.922605),60614-20210112
60614,01/13/2021,234,4064,145,2855,0.04,89,1209,0.017,71954,POINT (-87.652064 41.922605),60614-20210113
60614,01/14/2021,119,4183,84,2939,0.041,35,1244,0.017,71954,POINT (-87.652064 41.922605),60614-20210114
60614,01/15/2021,268,4451,247,3186,0.044,21,1265,0.018,71954,POINT (-87.652064 41.922605),60614-20210115
60614,01/08/2021,400,2896,92,2357,0.033,308,539,0.007,71954,POINT (-87.652064 41.922605),60614-20210108
60615,01/11/2021,102,2166,25,1741,0.043,77,425,0.01,40590,POINT (-87.602725 41.801993),60615-20210111
60615,01/12/2021,126,2292,54,1795,0.044,72,497,0.012,40590,POINT (-87.602725 41.801993),60615-20210112
60615,01/13/2021,125,2417,48,1843,0.045,77,574,0.014,40590,POINT (-87.602725 41.801993),60615-20210113
60615,01/14/2021,71,2488,54,1897,0.047,17,591,0.015,40590,POINT (-87.602725 41.801993),60615-20210114
60615,01/15/2021,86,2574,55,1952,0.048,31,622,0.015,40590,POINT (-87.602725 41.801993),60615-20210115
60615,12/15/2020,1,1,1,1,0,0,0,0,40590,POINT (-87.602725 41.801993),60615-20201215
60615,12/16/2020,1,2,1,2,0,0,0,0,40590,POINT (-87.602725 41.801993),60615-20201216
60615,12/17/2020,26,28,26,28,0.001,0,0,0,40590,POINT (-87.602725 41.801993),60615-20201217
60615,12/18/2020,95,123,95,123,0.003,0,0,0,40590,POINT (-87.602725 41.801993),60615-20201218
60615,12/19/2020,52,175,52,175,0.004,0,0,0,40590,POINT (-87.602725 41.801993),60615-20201219
60615,12/20/2020,49,224,49,224,0.006,0,0,0,40590,POINT (-87.602725 41.801993),60615-20201220
60615,12/21/2020,44,268,44,268,0.007,0,0,0,40590,POINT (-87.602725 41.801993),60615-20201221
60615,12/22/2020,130,398,130,398,0.01,0,0,0,40590,POINT (-87.602725 41.801993),60615-20201222
60615,12/23/2020,167,565,167,565,0.014,0,0,0,40590,POINT (-87.602725 41.801993),60615-20201223
60615,12/24/2020,60,625,60,625,0.015,0,0,0,40590,POINT (-87.602725 41.801993),60615-20201224
60615,12/25/2020,0,625,0,625,0.015,0,0,0,40590,POINT (-87.602725 41.801993),60615-20201225
60615,12/26/2020,7,632,7,632,0.016,0,0,0,40590,POINT (-87.602725 41.801993),60615-20201226
60615,12/27/2020,0,632,0,632,0.016,0,0,0,40590,POINT (-87.602725 41.801993),60615-20201227
60615,12/28/2020,22,654,22,654,0.016,0,0,0,40590,POINT (-87.602725 41.801993),60615-20201228
60615,12/29/2020,120,774,120,774,0.019,0,0,0,40590,POINT (-87.602725 41.801993),60615-20201229
60615,12/30/2020,229,1003,229,1003,0.025,0,0,0,40590,POINT (-87.602725 41.801993),60615-20201230
60615,12/31/2020,115,1118,115,1118,0.028,0,0,0,40590,POINT (-87.602725 41.801993),60615-20201231
60615,01/01/2021,0,1118,0,1118,0.028,0,0,0,40590,POINT (-87.602725 41.801993),60615-20210101
60615,01/02/2021,3,1121,3,1121,0.028,0,0,0,40590,POINT (-87.602725 41.801993),60615-20210102
60615,01/03/2021,156,1277,150,1271,0.031,6,6,0,40590,POINT (-87.602725 41.801993),60615-20210103
60615,01/04/2021,169,1446,156,1427,0.035,13,19,0,40590,POINT (-87.602725 41.801993),60615-20210104
60615,01/05/2021,57,1503,35,1462,0.036,22,41,0.001,40590,POINT (-87.602725 41.801993),60615-20210105
60615,01/06/2021,100,1603,78,1540,0.038,22,63,0.002,40590,POINT (-87.602725 41.801993),60615-20210106
60615,01/07/2021,115,1718,68,1608,0.04,47,110,0.003,40590,POINT (-87.602725 41.801993),60615-20210107
60615,01/08/2021,154,1872,73,1681,0.041,81,191,0.005,40590,POINT (-87.602725 41.801993),60615-20210108
60615,01/09/2021,106,1978,25,1706,0.042,81,272,0.007,40590,POINT (-87.602725 41.801993),60615-20210109
60615,01/10/2021,86,2064,10,1716,0.042,76,348,0.009,40590,POINT (-87.602725 41.801993),60615-20210110
60617,01/14/2021,62,965,51,782,0.009,11,183,0.002,83553,POINT (-87.556897 41.721257),60617-20210114
60616,01/09/2021,101,1713,30,1373,0.025,71,340,0.006,54197,POINT (-87.629531 41.844869),60616-20210109
60616,01/10/2021,36,1749,9,1382,0.025,27,367,0.007,54197,POINT (-87.629531 41.844869),60616-20210110
60616,01/11/2021,179,1928,98,1480,0.027,81,448,0.008,54197,POINT (-87.629531 41.844869),60616-20210111
60616,01/12/2021,144,2072,55,1535,0.028,89,537,0.01,54197,POINT (-87.629531 41.844869),60616-20210112
60616,01/13/2021,170,2242,119,1654,0.031,51,588,0.011,54197,POINT (-87.629531 41.844869),60616-20210113
60616,01/14/2021,83,2325,56,1710,0.032,27,615,0.011,54197,POINT (-87.629531 41.844869),60616-20210114
60616,01/15/2021,73,2398,64,1774,0.033,9,624,0.012,54197,POINT (-87.629531 41.844869),60616-20210115
60617,01/15/2021,115,1080,107,889,0.011,8,191,0.002,83553,POINT (-87.556897 41.721257),60617-20210115
60619,01/11/2021,37,551,21,484,0.008,16,67,0.001,61207,POINT (-87.60569 41.744737),60619-20210111
60619,01/12/2021,50,601,37,521,0.009,13,80,0.001,61207,POINT (-87.60569 41.744737),60619-20210112
60619,01/13/2021,86,687,70,591,0.01,16,96,0.002,61207,POINT (-87.60569 41.744737),60619-20210113
60619,01/14/2021,138,825,130,721,0.012,8,104,0.002,61207,POINT (-87.60569 41.744737),60619-20210114
60619,01/15/2021,42,867,38,759,0.012,4,108,0.002,61207,POINT (-87.60569 41.744737),60619-20210115
60624,01/05/2021,21,168,21,168,0.005,0,0,0,34892,POINT (-87.722735 41.879417),60624-20210105
60624,01/06/2021,18,186,17,185,0.005,1,1,0,34892,POINT (-87.722735 41.879417),60624-20210106
60624,01/07/2021,25,211,15,200,0.006,10,11,0,34892,POINT (-87.722735 41.879417),60624-20210107
60624,01/08/2021,21,232,13,213,0.006,8,19,0.001,34892,POINT (-87.722735 41.879417),60624-20210108
60624,01/09/2021,11,243,8,221,0.006,3,22,0.001,34892,POINT (-87.722735 41.879417),60624-20210109
60624,01/10/2021,3,246,1,222,0.006,2,24,0.001,34892,POINT (-87.722735 41.879417),60624-20210110
60624,01/11/2021,19,265,12,234,0.007,7,31,0.001,34892,POINT (-87.722735 41.879417),60624-20210111
60624,01/12/2021,34,299,28,262,0.008,6,37,0.001,34892,POINT (-87.722735 41.879417),60624-20210112
60624,01/13/2021,30,329,20,282,0.008,10,47,0.001,34892,POINT (-87.722735 41.879417),60624-20210113
60624,01/14/2021,58,387,57,339,0.01,1,48,0.001,34892,POINT (-87.722735 41.879417),60624-20210114
60624,01/15/2021,28,415,25,364,0.01,3,51,0.001,34892,POINT (-87.722735 41.879417),60624-20210115
60624,01/16/2021,10,425,8,372,0.011,2,53,0.002,34892,POINT (-87.722735 41.879417),60624-20210116
60624,01/17/2021,4,429,4,376,0.011,0,53,0.002,34892,POINT (-87.722735 41.879417),60624-20210117
60626,12/30/2020,292,709,292,709,0.014,0,0,0,50544,POINT (-87.669834 42.009469),60626-20201230
60626,12/31/2020,32,741,32,741,0.015,0,0,0,50544,POINT (-87.669834 42.009469),60626-20201231
60626,01/01/2021,0,741,0,741,0.015,0,0,0,50544,POINT (-87.669834 42.009469),60626-20210101
60626,01/02/2021,13,754,13,754,0.015,0,0,0,50544,POINT (-87.669834 42.009469),60626-20210102
60626,01/03/2021,19,773,18,772,0.015,1,1,0,50544,POINT (-87.669834 42.009469),60626-20210103
60626,01/04/2021,73,846,72,844,0.017,1,2,0,50544,POINT (-87.669834 42.009469),60626-20210104
60626,01/05/2021,148,994,147,991,0.02,1,3,0,50544,POINT (-87.669834 42.009469),60626-20210105
60626,01/06/2021,85,1079,69,1060,0.021,16,19,0,50544,POINT (-87.669834 42.009469),60626-20210106
60631,01/04/2021,59,671,58,670,0.023,1,1,0,29529,POINT (-87.813371 41.995019),60631-20210104
60631,01/05/2021,49,720,48,718,0.024,1,2,0,29529,POINT (-87.813371 41.995019),60631-20210105
60630,01/07/2021,115,1100,56,1017,0.018,59,83,0.001,56433,POINT (-87.759611 41.971261),60630-20210107
60630,01/08/2021,147,1247,61,1078,0.019,86,169,0.003,56433,POINT (-87.759611 41.971261),60630-20210108
60630,01/09/2021,75,1322,21,1099,0.019,54,223,0.004,56433,POINT (-87.759611 41.971261),60630-20210109
60630,01/10/2021,17,1339,7,1106,0.02,10,233,0.004,56433,POINT (-87.759611 41.971261),60630-20210110
60630,01/11/2021,113,1452,34,1140,0.02,79,312,0.006,56433,POINT (-87.759611 41.971261),60630-20210111
60630,01/12/2021,103,1555,71,1211,0.021,32,344,0.006,56433,POINT (-87.759611 41.971261),60630-20210112
60630,01/13/2021,113,1668,71,1282,0.023,42,386,0.007,56433,POINT (-87.759611 41.971261),60630-20210113
60630,01/14/2021,91,1759,75,1357,0.024,16,402,0.007,56433,POINT (-87.759611 41.971261),60630-20210114
60630,01/15/2021,67,1826,61,1418,0.025,6,408,0.007,56433,POINT (-87.759611 41.971261),60630-20210115
60631,01/02/2021,133,603,133,603,0.02,0,0,0,29529,POINT (-87.813371 41.995019),60631-20210102
60631,01/03/2021,9,612,9,612,0.021,0,0,0,29529,POINT (-87.813371 41.995019),60631-20210103
60634,12/15/2020,0,0,0,0,0,0,0,0,75082,POINT (-87.797373 41.944967),60634-20201215
60634,12/16/2020,1,1,1,1,0,0,0,0,75082,POINT (-87.797373 41.944967),60634-20201216
60634,12/17/2020,29,30,29,30,0,0,0,0,75082,POINT (-87.797373 41.944967),60634-20201217
60634,12/18/2020,105,135,105,135,0.002,0,0,0,75082,POINT (-87.797373 41.944967),60634-20201218
60634,12/19/2020,74,209,74,209,0.003,0,0,0,75082,POINT (-87.797373 41.944967),60634-20201219
60634,12/20/2020,19,228,19,228,0.003,0,0,0,75082,POINT (-87.797373 41.944967),60634-20201220
60634,12/21/2020,97,325,97,325,0.004,0,0,0,75082,POINT (-87.797373 41.944967),60634-20201221
60634,12/22/2020,71,396,71,396,0.005,0,0,0,75082,POINT (-87.797373 41.944967),60634-20201222
60634,12/24/2020,7,456,7,456,0.006,0,0,0,75082,POINT (-87.797373 41.944967),60634-20201224
60634,12/25/2020,0,456,0,456,0.006,0,0,0,75082,POINT (-87.797373 41.944967),60634-20201225
60634,12/26/2020,9,465,9,465,0.006,0,0,0,75082,POINT (-87.797373 41.944967),60634-20201226
60634,12/27/2020,0,465,0,465,0.006,0,0,0,75082,POINT (-87.797373 41.944967),60634-20201227
60634,12/28/2020,25,490,25,490,0.007,0,0,0,75082,POINT (-87.797373 41.944967),60634-20201228
60634,12/29/2020,106,596,106,596,0.008,0,0,0,75082,POINT (-87.797373 41.944967),60634-20201229
60634,12/30/2020,73,669,73,669,0.009,0,0,0,75082,POINT (-87.797373 41.944967),60634-20201230
60634,12/31/2020,56,725,56,725,0.01,0,0,0,75082,POINT (-87.797373 41.944967),60634-20201231
60634,01/01/2021,1,726,1,726,0.01,0,0,0,75082,POINT (-87.797373 41.944967),60634-20210101
60634,01/02/2021,109,835,109,835,0.011,0,0,0,75082,POINT (-87.797373 41.944967),60634-20210102
60634,01/03/2021,15,850,15,850,0.011,0,0,0,75082,POINT (-87.797373 41.944967),60634-20210103
60634,01/04/2021,99,949,98,948,0.013,1,1,0,75082,POINT (-87.797373 41.944967),60634-20210104
60634,01/05/2021,93,1042,88,1036,0.014,5,6,0,75082,POINT (-87.797373 41.944967),60634-20210105
60634,01/06/2021,71,1113,56,1092,0.015,15,21,0,75082,POINT (-87.797373 41.944967),60634-20210106
60636,01/20/2021,22,295,15,252,0.008,7,43,0.001,30024,POINT (-87.668597 41.77599),60636-20210120
60636,01/21/2021,58,353,47,299,0.01,11,54,0.002,30024,POINT (-87.668597 41.77599),60636-20210121
60636,01/22/2021,67,420,63,362,0.012,4,58,0.002,30024,POINT (-87.668597 41.77599),60636-20210122
60636,01/23/2021,11,431,11,373,0.012,0,58,0.002,30024,POINT (-87.668597 41.77599),60636-20210123
60636,01/24/2021,13,444,10,383,0.013,3,61,0.002,30024,POINT (-87.668597 41.77599),60636-20210124
60636,01/25/2021,45,489,33,416,0.014,12,73,0.002,30024,POINT (-87.668597 41.77599),60636-20210125
60641,01/16/2021,79,1956,66,1534,0.022,13,422,0.006,69880,POINT (-87.746791 41.946682),60641-20210116
60641,01/17/2021,24,1980,12,1546,0.022,12,434,0.006,69880,POINT (-87.746791 41.946682),60641-20210117
60641,12/28/2020,42,483,42,483,0.007,0,0,0,69880,POINT (-87.746791 41.946682),60641-20201228
60641,12/29/2020,78,561,78,561,0.008,0,0,0,69880,POINT (-87.746791 41.946682),60641-20201229
60641,12/30/2020,77,638,77,638,0.009,0,0,0,69880,POINT (-87.746791 41.946682),60641-20201230
60641,12/31/2020,30,668,30,668,0.01,0,0,0,69880,POINT (-87.746791 41.946682),60641-20201231
60641,01/01/2021,0,668,0,668,0.01,0,0,0,69880,POINT (-87.746791 41.946682),60641-20210101
60641,01/02/2021,22,690,22,690,0.01,0,0,0,69880,POINT (-87.746791 41.946682),60641-20210102
60641,01/03/2021,18,708,18,708,0.01,0,0,0,69880,POINT (-87.746791 41.946682),60641-20210103
60641,01/04/2021,110,818,110,818,0.012,0,0,0,69880,POINT (-87.746791 41.946682),60641-20210104
60641,01/05/2021,74,892,74,892,0.013,0,0,0,69880,POINT (-87.746791 41.946682),60641-20210105
60641,01/06/2021,88,980,59,951,0.014,29,29,0,69880,POINT (-87.746791 41.946682),60641-20210106
60641,01/07/2021,97,1077,40,991,0.014,57,86,0.001,69880,POINT (-87.746791 41.946682),60641-20210107
60641,01/08/2021,145,1222,63,1054,0.015,82,168,0.002,69880,POINT (-87.746791 41.946682),60641-20210108
60641,01/09/2021,66,1288,26,1080,0.015,40,208,0.003,69880,POINT (-87.746791 41.946682),60641-20210109
60641,01/10/2021,19,1307,11,1091,0.016,8,216,0.003,69880,POINT (-87.746791 41.946682),60641-20210110
60641,01/11/2021,100,1407,40,1131,0.016,60,276,0.004,69880,POINT (-87.746791 41.946682),60641-20210111
60641,01/12/2021,132,1539,89,1220,0.017,43,319,0.005,69880,POINT (-87.746791 41.946682),60641-20210112
60641,01/13/2021,151,1690,93,1313,0.019,58,377,0.005,69880,POINT (-87.746791 41.946682),60641-20210113
60641,01/14/2021,97,1787,77,1390,0.02,20,397,0.006,69880,POINT (-87.746791 41.946682),60641-20210114
60641,01/15/2021,90,1877,78,1468,0.021,12,409,0.006,69880,POINT (-87.746791 41.946682),60641-20210115
60642,01/26/2021,93,2245,44,1504,0.076,49,741,0.038,19716,POINT (-87.657821 41.899935),60642-20210126
60643,01/07/2021,73,773,27,700,0.014,46,73,0.001,48887,POINT (-87.662381 41.700445),60643-20210107
60643,01/08/2021,90,863,32,732,0.015,58,131,0.003,48887,POINT (-87.662381 41.700445),60643-20210108
60643,01/09/2021,51,914,14,746,0.015,37,168,0.003,48887,POINT (-87.662381 41.700445),60643-20210109
60643,01/10/2021,10,924,2,748,0.015,8,176,0.004,48887,POINT (-87.662381 41.700445),60643-20210110
60643,01/11/2021,82,1006,44,792,0.016,38,214,0.004,48887,POINT (-87.662381 41.700445),60643-20210111
60643,01/12/2021,81,1087,41,833,0.017,40,254,0.005,48887,POINT (-87.662381 41.700445),60643-20210112
60643,01/13/2021,326,1413,295,1128,0.023,31,285,0.006,48887,POINT (-87.662381 41.700445),60643-20210113
60643,01/14/2021,50,1463,45,1173,0.024,5,290,0.006,48887,POINT (-87.662381 41.700445),60643-20210114
60643,01/15/2021,65,1528,58,1231,0.025,7,297,0.006,48887,POINT (-87.662381 41.700445),60643-20210115
60643,01/16/2021,60,1588,56,1287,0.026,4,301,0.006,48887,POINT (-87.662381 41.700445),60643-20210116
60643,01/17/2021,10,1598,6,1293,0.026,4,305,0.006,48887,POINT (-87.662381 41.700445),60643-20210117
60652,01/02/2021,12,393,12,393,0.009,0,0,0,43447,POINT (-87.714238 41.745398),60652-20210102
60652,01/03/2021,11,404,11,404,0.009,0,0,0,43447,POINT (-87.714238 41.745398),60652-20210103
60652,01/04/2021,30,434,29,433,0.01,1,1,0,43447,POINT (-87.714238 41.745398),60652-20210104
60652,01/05/2021,36,470,35,468,0.011,1,2,0,43447,POINT (-87.714238 41.745398),60652-20210105
60652,01/06/2021,21,491,15,483,0.011,6,8,0,43447,POINT (-87.714238 41.745398),60652-20210106
60652,01/07/2021,43,534,30,513,0.012,13,21,0,43447,POINT (-87.714238 41.745398),60652-20210107
60652,01/08/2021,48,582,27,540,0.012,21,42,0.001,43447,POINT (-87.714238 41.745398),60652-20210108
60652,01/09/2021,24,606,15,555,0.013,9,51,0.001,43447,POINT (-87.714238 41.745398),60652-20210109
60652,01/10/2021,12,618,3,558,0.013,9,60,0.001,43447,POINT (-87.714238 41.745398),60652-20210110
60652,01/11/2021,32,650,12,570,0.013,20,80,0.002,43447,POINT (-87.714238 41.745398),60652-20210111
60652,01/12/2021,54,704,30,600,0.014,24,104,0.002,43447,POINT (-87.714238 41.745398),60652-20210112
60652,01/13/2021,77,781,53,653,0.015,24,128,0.003,43447,POINT (-87.714238 41.745398),60652-20210113
60652,01/14/2021,43,824,39,692,0.016,4,132,0.003,43447,POINT (-87.714238 41.745398),60652-20210114
60652,01/15/2021,30,854,24,716,0.016,6,138,0.003,43447,POINT (-87.714238 41.745398),60652-20210115
60653,01/15/2021,26,937,21,775,0.023,5,162,0.005,33154,POINT (-87.611244 41.819261),60653-20210115
60654,12/15/2020,0,0,0,0,0,0,0,0,20022,POINT (-87.636354 41.892485),60654-20201215
60654,12/16/2020,5,5,5,5,0,0,0,0,20022,POINT (-87.636354 41.892485),60654-20201216
60654,12/17/2020,69,74,69,74,0.004,0,0,0,20022,POINT (-87.636354 41.892485),60654-20201217
60654,12/18/2020,136,210,136,210,0.01,0,0,0,20022,POINT (-87.636354 41.892485),60654-20201218
60654,12/19/2020,81,291,81,291,0.015,0,0,0,20022,POINT (-87.636354 41.892485),60654-20201219
60654,12/20/2020,14,305,14,305,0.015,0,0,0,20022,POINT (-87.636354 41.892485),60654-20201220
60655,01/05/2021,36,717,31,711,0.025,5,6,0,28569,POINT (-87.701434 41.696456),60655-20210105
60655,01/06/2021,54,771,34,745,0.026,20,26,0.001,28569,POINT (-87.701434 41.696456),60655-20210106
60655,01/07/2021,119,890,30,775,0.027,89,115,0.004,28569,POINT (-87.701434 41.696456),60655-20210107
60655,01/08/2021,86,976,20,795,0.028,66,181,0.006,28569,POINT (-87.701434 41.696456),60655-20210108
60655,01/09/2021,41,1017,4,799,0.028,37,218,0.008,28569,POINT (-87.701434 41.696456),60655-20210109
60655,01/10/2021,25,1042,3,802,0.028,22,240,0.008,28569,POINT (-87.701434 41.696456),60655-20210110
60655,01/11/2021,77,1119,26,828,0.029,51,291,0.01,28569,POINT (-87.701434 41.696456),60655-20210111
60655,01/12/2021,53,1172,25,853,0.03,28,319,0.011,28569,POINT (-87.701434 41.696456),60655-20210112
60655,01/13/2021,124,1296,105,958,0.034,19,338,0.012,28569,POINT (-87.701434 41.696456),60655-20210113
60655,01/14/2021,91,1387,77,1035,0.036,14,352,0.012,28569,POINT (-87.701434 41.696456),60655-20210114
60656,01/12/2021,30,608,15,439,0.016,15,169,0.006,28218,POINT (-87.817934 41.974566),60656-20210112
60656,01/13/2021,57,665,42,481,0.017,15,184,0.007,28218,POINT (-87.817934 41.974566),60656-20210113
60657,01/07/2021,295,2996,98,2727,0.038,197,269,0.004,70958,POINT (-87.658216 41.939715),60657-20210107
60657,01/08/2021,452,3448,115,2842,0.04,337,606,0.009,70958,POINT (-87.658216 41.939715),60657-20210108
60657,01/09/2021,216,3664,60,2902,0.041,156,762,0.011,70958,POINT (-87.658216 41.939715),60657-20210109
60657,01/10/2021,147,3811,99,3001,0.042,48,810,0.011,70958,POINT (-87.658216 41.939715),60657-20210110
60657,01/11/2021,304,4115,72,3073,0.043,232,1042,0.015,70958,POINT (-87.658216 41.939715),60657-20210111
60657,01/12/2021,367,4482,187,3260,0.046,180,1222,0.017,70958,POINT (-87.658216 41.939715),60657-20210112
60657,01/13/2021,232,4714,120,3380,0.048,112,1334,0.019,70958,POINT (-87.658216 41.939715),60657-20210113
60657,01/14/2021,147,4861,99,3479,0.049,48,1382,0.019,70958,POINT (-87.658216 41.939715),60657-20210114
60657,01/15/2021,166,5027,140,3619,0.051,26,1408,0.02,70958,POINT (-87.658216 41.939715),60657-20210115
60659,12/15/2020,0,0,0,0,0,0,0,0,42735,POINT (-87.703266 41.990803),60659-20201215
60659,12/16/2020,2,2,2,2,0,0,0,0,42735,POINT (-87.703266 41.990803),60659-20201216
60659,12/17/2020,14,16,14,16,0,0,0,0,42735,POINT (-87.703266 41.990803),60659-20201217
60659,12/18/2020,44,60,44,60,0.001,0,0,0,42735,POINT (-87.703266 41.990803),60659-20201218
60659,12/19/2020,32,92,32,92,0.002,0,0,0,42735,POINT (-87.703266 41.990803),60659-20201219
60659,12/20/2020,7,99,7,99,0.002,0,0,0,42735,POINT (-87.703266 41.990803),60659-20201220
60659,12/21/2020,61,160,61,160,0.004,0,0,0,42735,POINT (-87.703266 41.990803),60659-20201221
60659,12/22/2020,35,195,35,195,0.005,0,0,0,42735,POINT (-87.703266 41.990803),60659-20201222
60659,12/23/2020,41,236,41,236,0.006,0,0,0,42735,POINT (-87.703266 41.990803),60659-20201223
60659,12/24/2020,8,244,8,244,0.006,0,0,0,42735,POINT (-87.703266 41.990803),60659-20201224
60659,12/25/2020,0,244,0,244,0.006,0,0,0,42735,POINT (-87.703266 41.990803),60659-20201225
60659,12/26/2020,4,248,4,248,0.006,0,0,0,42735,POINT (-87.703266 41.990803),60659-20201226
60659,12/27/2020,2,250,2,250,0.006,0,0,0,42735,POINT (-87.703266 41.990803),60659-20201227
60659,12/28/2020,27,277,27,277,0.006,0,0,0,42735,POINT (-87.703266 41.990803),60659-20201228
60659,12/29/2020,58,335,58,335,0.008,0,0,0,42735,POINT (-87.703266 41.990803),60659-20201229
60659,12/30/2020,45,380,45,380,0.009,0,0,0,42735,POINT (-87.703266 41.990803),60659-20201230
60659,12/31/2020,32,412,32,412,0.01,0,0,0,42735,POINT (-87.703266 41.990803),60659-20201231
60659,01/01/2021,0,412,0,412,0.01,0,0,0,42735,POINT (-87.703266 41.990803),60659-20210101
60659,01/02/2021,12,424,12,424,0.01,0,0,0,42735,POINT (-87.703266 41.990803),60659-20210102
60659,01/03/2021,23,447,23,447,0.01,0,0,0,42735,POINT (-87.703266 41.990803),60659-20210103
60659,01/04/2021,71,518,71,518,0.012,0,0,0,42735,POINT (-87.703266 41.990803),60659-20210104
60659,01/05/2021,66,584,65,583,0.014,1,1,0,42735,POINT (-87.703266 41.990803),60659-20210105
60659,01/06/2021,66,650,57,640,0.015,9,10,0,42735,POINT (-87.703266 41.990803),60659-20210106
60659,01/07/2021,98,748,60,700,0.016,38,48,0.001,42735,POINT (-87.703266 41.990803),60659-20210107
60659,01/08/2021,72,820,42,742,0.017,30,78,0.002,42735,POINT (-87.703266 41.990803),60659-20210108
60659,01/09/2021,38,858,15,757,0.018,23,101,0.002,42735,POINT (-87.703266 41.990803),60659-20210109
60707,01/18/2021,12,332,8,263,0.006,4,69,0.002,43093,POINT (-87.808283 41.921777),60707-20210118
60707,01/19/2021,94,426,80,343,0.008,14,83,0.002,43093,POINT (-87.808283 41.921777),60707-20210119
60666,02/02/2021,2,12,2,12,0,0,0,0,0,POINT (-87.896371 41.979511),60666-20210202
60707,01/14/2021,20,294,14,231,0.005,6,63,0.001,43093,POINT (-87.808283 41.921777),60707-20210114
60707,01/15/2021,16,310,14,245,0.006,2,65,0.002,43093,POINT (-87.808283 41.921777),60707-20210115
60707,01/16/2021,10,320,10,255,0.006,0,65,0.002,43093,POINT (-87.808283 41.921777),60707-20210116
60707,01/17/2021,0,320,0,255,0.006,0,65,0.002,43093,POINT (-87.808283 41.921777),60707-20210117
60707,01/20/2021,40,466,27,370,0.009,13,96,0.002,43093,POINT (-87.808283 41.921777),60707-20210120
60707,01/21/2021,44,510,38,408,0.009,6,102,0.002,43093,POINT (-87.808283 41.921777),60707-20210121
60707,01/22/2021,45,555,43,451,0.01,2,104,0.002,43093,POINT (-87.808283 41.921777),60707-20210122
60707,01/23/2021,28,583,28,479,0.011,0,104,0.002,43093,POINT (-87.808283 41.921777),60707-20210123
60707,01/24/2021,2,585,1,480,0.011,1,105,0.002,43093,POINT (-87.808283 41.921777),60707-20210124
60707,01/25/2021,11,596,8,488,0.011,3,108,0.003,43093,POINT (-87.808283 41.921777),60707-20210125
60707,01/26/2021,31,627,22,510,0.012,9,117,0.003,43093,POINT (-87.808283 41.921777),60707-20210126
60666,02/03/2021,1,13,1,13,0,0,0,0,0,POINT (-87.896371 41.979511),60666-20210203
60603,02/03/2021,18,366,17,316,0.3,1,50,0.048,1052,POINT (-87.625473 41.880112),60603-20210203
60604,02/03/2021,7,200,6,181,0.22,1,19,0.023,823,POINT (-87.629029 41.878153),60604-20210203
